Player,Pos,Squad,Comp,Age,90s,Tackles-Tkl,Tackles-TklW,Tackles-Def 3rd,Tackles-Mid 3rd,Tackles-Att 3rd,Challenges-Tkl,Challenges-Att,Challenges-Tkl%,Challenges-Lost,Blocks-Blocks,Blocks-Sh,Blocks-Pass,Int,Tkl+Int,Clr,Err
Max Aarons,DF,Bournemouth,eng Premier League,23,13.7,29,19,20,7,2,20,34,58.8,14,9,5,4,8,37,27,0
Brenden Aaronson,"MF,FW",Union Berlin,de Bundesliga,22,14.1,32,18,13,13,6,16,32,50.0,16,26,1,25,2,34,4,0
Yunis Abdelhamid,DF,Reims,fr Ligue 1,35,30.9,64,35,36,23,5,26,45,57.8,19,51,32,19,39,103,109,2
Salis Abdul Samed,MF,Lens,fr Ligue 1,23,16.9,21,14,8,10,3,8,18,44.4,10,12,1,11,12,33,18,0
Laurent Abergel,MF,Lorient,fr Ligue 1,30,31.8,85,52,43,34,8,38,96,39.6,58,29,6,23,61,146,61,3
Matthis Abline,FW,Nantes,fr Ligue 1,20,11.6,9,4,4,3,2,3,8,37.5,5,3,0,3,3,12,5,0
Abner,DF,Betis,es La Liga,23,15.6,25,19,15,9,1,17,34,50.0,17,23,5,18,15,40,62,0
Zakaria Aboukhlal,"MF,FW",Toulouse,fr Ligue 1,23,8.4,9,8,1,5,3,3,12,25.0,9,9,1,8,1,10,2,0
Abdel Abqar,DF,Alavés,es La Liga,24,25.7,35,19,28,5,2,21,35,60.0,14,31,26,5,23,58,115,0
Francesco Acerbi,DF,Inter,it Serie A,35,26.5,22,13,16,6,0,11,14,78.6,3,20,13,7,32,54,77,1
Marcos Acuña,DF,Sevilla,es La Liga,31,14.4,33,21,20,12,1,9,14,64.3,5,12,2,10,4,37,25,0
Bénie Adama Traore,"FW,MF",Sheffield Utd,eng Premier League,20,4.3,4,2,1,2,1,0,4,0.0,4,4,1,3,1,5,1,0
Bénie Adama Traore,"FW,MF",Nantes,fr Ligue 1,20,5.6,8,4,2,5,1,3,7,42.9,4,3,0,3,1,9,1,0
Akor Adams,FW,Montpellier,fr Ligue 1,23,25.0,12,4,3,4,5,3,7,42.9,4,9,2,7,5,17,11,0
Sargis Adamyan,"FW,MF",Köln,de Bundesliga,30,8.9,14,9,2,9,3,6,11,54.5,5,16,1,15,5,19,7,0
Tosin Adarabioyo,DF,Fulham,eng Premier League,25,18.0,21,11,16,5,0,12,21,57.1,9,16,11,5,25,46,80,0
Elijah Adebayo,FW,Luton Town,eng Premier League,25,15.8,4,1,1,0,3,1,12,8.3,11,13,2,11,6,10,25,0
Karim Adeyemi,"FW,MF",Dortmund,de Bundesliga,21,10.1,16,14,9,4,3,8,20,40.0,12,11,0,11,3,19,5,0
Simon Adingra,FW,Brighton,eng Premier League,21,24.7,45,20,23,11,11,19,42,45.2,23,31,1,30,19,64,22,0
Nathaniel Adjei,DF,Lorient,fr Ligue 1,20,13.8,13,9,8,3,2,6,7,85.7,1,15,8,7,18,31,64,1
Amine Adli,"MF,FW",Leverkusen,de Bundesliga,23,10.0,16,7,2,10,4,7,17,41.2,10,10,2,8,6,22,5,0
Yacine Adli,MF,Milan,it Serie A,23,15.6,34,17,17,13,4,13,35,37.1,22,22,8,14,20,54,15,1
Michel Aebischer,MF,Bologna,it Serie A,26,24.8,35,20,9,20,6,15,34,44.1,19,28,6,22,12,47,22,0
Emmanuel Agbadou,DF,Reims,fr Ligue 1,26,28.8,65,41,38,23,4,44,64,68.8,20,47,25,22,55,120,116,1
Lucien Agoume,MF,Sevilla,es La Liga,21,8.6,23,18,7,14,2,9,12,75.0,3,6,1,5,7,30,8,0
Felix Agu,"DF,MF",Werder Bremen,de Bundesliga,23,17.9,45,29,28,13,4,29,41,70.7,12,27,7,20,13,58,41,0
Nayef Aguerd,DF,West Ham,eng Premier League,27,20.6,26,14,19,7,0,16,22,72.7,6,33,24,9,17,43,85,2
Ruben Aguilar,DF,Lens,fr Ligue 1,30,21.4,53,31,27,23,3,27,45,60.0,18,35,5,30,26,79,46,0
Anel Ahmedhodžić,DF,Sheffield Utd,eng Premier League,24,29.4,64,36,48,14,2,30,49,61.2,19,43,26,17,35,99,137,2
Joseph Aidoo,DF,Celta Vigo,es La Liga,27,4.5,8,3,6,2,0,4,8,50.0,4,3,1,2,4,12,28,0
Ola Aina,DF,Nott'ham Forest,eng Premier League,26,18.8,47,31,31,12,4,29,41,70.7,12,19,3,16,18,65,51,1
Rayan Aït-Nouri,"DF,MF",Wolves,eng Premier League,22,25.9,71,44,41,23,7,28,49,57.1,21,32,6,26,15,86,38,0
Tosin Aiyegun,"MF,FW",Lorient,fr Ligue 1,25,10.0,6,4,2,3,1,3,9,33.3,6,4,1,3,2,8,8,0
Kristoffer Ajer,DF,Brentford,eng Premier League,25,20.4,38,21,25,9,4,23,36,63.9,13,26,11,15,25,63,79,1
Ludovic Ajorque,FW,Mainz 05,de Bundesliga,29,15.1,3,2,1,2,0,2,11,18.2,9,6,2,4,4,7,11,0
Manuel Akanji,"DF,MF",Manchester City,eng Premier League,28,27.9,42,28,16,18,8,22,39,56.4,17,28,12,16,23,65,70,3
Nathan Aké,DF,Manchester City,eng Premier League,28,22.7,26,16,15,8,3,13,20,65.0,7,17,2,15,14,40,54,0
Ilias Akhomach,"MF,FW",Villarreal,es La Liga,19,16.8,36,21,11,16,9,10,20,50.0,10,10,2,8,13,49,13,0
Sergio Akieme,DF,Almería,es La Liga,25,18.6,27,15,18,7,2,13,16,81.3,3,14,4,10,10,37,34,0
Sergio Akieme,DF,Reims,fr Ligue 1,25,9.1,11,5,6,3,2,8,11,72.7,3,9,3,6,10,21,25,0
Maghnes Akliouche,"MF,FW",Monaco,fr Ligue 1,21,17.9,37,23,12,20,5,12,36,33.3,24,21,0,21,9,46,3,0
Jean-Daniel Akpa-Akpro,MF,Monza,it Serie A,30,7.8,20,11,14,4,2,3,9,33.3,6,10,4,6,12,32,15,1
Kevin Akpoguma,DF,Hoffenheim,de Bundesliga,28,12.2,35,18,22,12,1,26,35,74.3,9,28,8,20,18,53,32,0
David Alaba,DF,Real Madrid,es La Liga,31,12.8,13,9,7,5,1,4,8,50.0,4,10,7,3,15,28,34,0
Luis Alberto,MF,Lazio,it Serie A,30,25.7,35,20,16,12,7,15,53,28.3,38,34,4,30,7,42,13,0
Raúl Albiol,DF,Villarreal,es La Liga,37,22.6,25,14,15,9,1,18,27,66.7,9,31,24,7,16,41,102,0
Carlos Alcaraz,MF,Juventus,it Serie A,20,4.2,6,6,0,6,0,5,10,50.0,5,5,2,3,5,11,4,0
Rubén Alcaraz,MF,Cádiz,es La Liga,32,34.8,97,59,39,52,6,50,121,41.3,71,60,14,46,33,130,55,2
Omar Alderete,DF,Getafe,es La Liga,26,24.4,28,21,15,13,0,19,35,54.3,16,30,18,12,13,41,111,0
Iván Alejo,MF,Cádiz,es La Liga,28,18.8,40,23,23,11,6,17,57,29.8,40,20,0,20,7,47,17,0
Carles Aleñá,MF,Getafe,es La Liga,25,11.3,24,8,7,14,3,10,24,41.7,14,14,3,11,4,28,13,0
Trent Alexander-Arnold,DF,Liverpool,eng Premier League,24,23.9,39,26,26,11,2,27,87,31.0,60,22,2,20,31,70,48,5
Mohamed Ali Cho,FW,Nice,fr Ligue 1,19,9.6,12,9,4,7,1,3,11,27.3,8,10,0,10,3,15,6,0
Faride Alidou,"FW,MF",Köln,de Bundesliga,22,14.2,10,4,3,6,1,4,18,22.2,14,23,2,21,8,18,15,1
Nabil Alioui,"MF,FW",Le Havre,fr Ligue 1,24,11.2,3,2,2,1,0,2,4,50.0,2,6,1,5,3,6,4,0
Alisson,GK,Liverpool,eng Premier League,30,28.0,0,0,0,0,0,0,1,0.0,1,0,0,0,0,0,11,4
Jim Allevinah,"MF,DF",Clermont Foot,fr Ligue 1,28,20.7,30,18,11,14,5,14,35,40.0,21,20,3,17,13,43,30,0
Domingos André Ribeiro Almeida,"FW,MF",Valencia,es La Liga,23,10.7,25,15,9,12,4,9,19,47.4,10,13,1,12,6,31,5,0
Miguel Almirón,FW,Newcastle Utd,eng Premier League,29,21.5,36,24,13,15,8,11,29,37.9,18,29,2,27,10,46,13,0
Pontus Almqvist,"FW,MF",Lecce,it Serie A,24,23.4,45,29,16,22,7,23,51,45.1,28,21,2,19,14,59,10,0
Adrià Altimira,"DF,MF",Villarreal,es La Liga,22,8.6,16,7,9,6,1,9,24,37.5,15,18,5,13,5,21,18,0
Sergi Altimira,MF,Betis,es La Liga,21,6.3,15,8,8,6,1,11,23,47.8,12,12,1,11,9,24,10,0
Edson Álvarez,MF,West Ham,eng Premier League,25,26.4,80,39,47,26,7,31,66,47.0,35,59,20,39,42,122,81,0
Gastón Álvarez,DF,Getafe,es La Liga,23,28.2,68,37,43,20,5,37,57,64.9,20,40,11,29,35,103,80,0
Hugo Álvarez,"MF,DF",Celta Vigo,es La Liga,20,8.5,14,9,8,3,3,9,20,45.0,11,4,1,3,5,19,9,0
Julián Álvarez,"MF,FW",Manchester City,eng Premier League,23,29.4,24,13,5,8,11,8,32,25.0,24,30,0,30,2,26,14,1
Yeray Álvarez,DF,Athletic Club,es La Liga,28,12.8,18,9,15,3,0,12,19,63.2,7,8,5,3,11,29,34,1
Skelly Alvero,MF,Lyon,fr Ligue 1,21,4.7,8,7,5,2,1,2,9,22.2,7,5,1,4,2,10,5,0
Papa Amadou Diallo,FW,Metz,fr Ligue 1,19,9.9,18,8,10,7,1,7,21,33.3,14,11,1,10,11,29,16,0
Selim Amallah,"FW,MF",Valencia,es La Liga,26,6.7,17,12,7,7,3,3,9,33.3,6,13,0,13,11,28,6,0
Amath,"FW,MF",Mallorca,es La Liga,27,4.4,9,6,7,2,0,2,10,20.0,8,2,0,2,3,12,6,0
Zeki Amdouni,FW,Burnley,eng Premier League,22,21.7,27,18,1,15,11,7,25,28.0,18,23,10,13,9,36,10,0
Kelvin Amian,DF,Nantes,fr Ligue 1,25,8.9,16,7,12,4,0,11,15,73.3,4,6,0,6,7,23,28,0
Bruno Amione,DF,Hellas Verona,it Serie A,21,6.4,11,3,9,2,0,4,5,80.0,1,4,2,2,9,20,19,2
Michael Amir Murillo,DF,Marseille,fr Ligue 1,27,11.1,23,11,13,6,4,15,23,65.2,8,9,2,7,11,34,34,2
Nadiem Amiri,MF,Mainz 05,de Bundesliga,26,14.6,22,14,8,10,4,13,19,68.4,6,16,2,14,14,36,18,0
Sofyan Amrabat,"MF,DF",Manchester Utd,eng Premier League,26,10.4,27,16,17,8,2,17,31,54.8,14,20,7,13,8,35,19,2
Joachim Andersen,DF,Crystal Palace,eng Premier League,27,37.9,56,35,33,21,2,29,39,74.4,10,33,18,15,41,97,207,1
Elliot Anderson,"MF,FW",Newcastle Utd,eng Premier League,20,11.4,24,18,12,9,3,15,29,51.7,14,23,4,19,8,32,23,0
Felipe Anderson,"FW,MF",Lazio,it Serie A,30,30.8,78,45,32,33,13,34,90,37.8,56,45,3,42,27,105,23,0
Benjamin André,MF,Lille,fr Ligue 1,32,28.6,89,49,39,45,5,43,81,53.1,38,34,5,29,35,124,60,0
Robert Andrich,"MF,DF",Leverkusen,de Bundesliga,28,18.8,30,18,8,14,8,13,24,54.2,11,15,4,11,20,50,17,0
Miguel Ángel Rubio,DF,Granada,es La Liga,25,17.3,20,12,14,6,0,14,21,66.7,7,31,18,13,28,48,74,2
Angeliño,DF,Roma,it Serie A,26,12.7,21,11,12,6,3,11,19,57.9,8,11,5,6,12,33,37,1
Waldemar Anton,DF,Stuttgart,de Bundesliga,27,32.1,39,25,21,16,2,23,42,54.8,19,33,20,13,40,79,150,1
Michail Antonio,FW,West Ham,eng Premier League,33,18.8,15,8,5,6,4,3,11,27.3,8,16,3,13,4,19,4,0
Antony,FW,Manchester Utd,eng Premier League,23,14.7,40,21,15,19,6,20,40,50.0,20,29,1,28,12,52,9,0
Christopher Antwi-Adjei,"FW,MF",Bochum,de Bundesliga,29,13.5,21,12,10,6,5,12,22,54.5,10,13,2,11,2,23,11,1
Houssem Aouar,"MF,FW",Roma,it Serie A,25,8.4,16,11,4,10,2,3,12,25.0,9,5,0,5,4,20,2,1
Jon Aramburu,DF,Real Sociedad,es La Liga,21,6.0,24,15,12,10,2,15,25,60.0,10,8,3,5,7,31,17,0
Julian Araujo,DF,Las Palmas,es La Liga,21,16.2,41,22,29,7,5,23,33,69.7,10,23,16,7,10,51,52,1
Ronald Araújo,DF,Barcelona,es La Liga,24,22.2,27,22,11,15,1,12,17,70.6,5,20,11,9,12,39,66,2
Oliver Arblaster,MF,Sheffield Utd,eng Premier League,19,10.5,23,14,11,8,4,7,15,46.7,8,17,7,10,15,38,9,0
Cameron Archer,"FW,MF",Sheffield Utd,eng Premier League,22,20.4,18,13,6,6,6,8,18,44.4,10,22,3,19,1,19,11,0
Alphonse Areola,GK,West Ham,eng Premier League,30,30.0,1,1,1,0,0,1,3,33.3,2,0,0,0,1,2,16,0
Jesús Areso,DF,Osasuna,es La Liga,24,29.6,45,24,25,13,7,31,38,81.6,7,36,15,21,18,63,58,0
Matias Arezo,FW,Granada,es La Liga,20,4.1,7,3,2,5,0,1,5,20.0,4,4,1,3,1,8,4,0
José Arnaiz,"FW,MF",Osasuna,es La Liga,28,10.3,14,8,6,4,4,6,21,28.6,15,11,2,9,3,17,2,0
Hákon Arnar Haraldsson,"FW,MF",Lille,fr Ligue 1,20,14.3,12,8,4,7,1,5,21,23.8,16,7,2,5,3,15,5,0
Marko Arnautović,FW,Inter,it Serie A,34,8.9,10,4,3,5,2,4,7,57.1,3,8,1,7,5,15,5,0
Maximilian Arnold,MF,Wolfsburg,de Bundesliga,29,27.8,51,31,15,27,9,28,57,49.1,29,23,4,19,24,75,60,0
Sergio Arribas,"MF,FW",Almería,es La Liga,21,22.7,34,17,16,17,1,14,31,45.2,17,20,1,19,16,50,8,1
Kepa Arrizabalaga,GK,Real Madrid,es La Liga,28,13.3,0,0,0,0,0,0,1,0.0,1,0,0,0,0,0,4,0
Takuma Asano,"FW,MF",Bochum,de Bundesliga,28,22.1,17,6,2,9,6,7,23,30.4,16,17,3,14,4,21,11,0
Marco Asensio,"MF,FW",Paris S-G,fr Ligue 1,27,12.4,12,10,4,7,1,4,13,30.8,9,7,0,7,5,17,2,0
Kristjan Asllani,MF,Inter,it Serie A,21,8.7,7,2,3,4,0,2,11,18.2,9,9,3,6,11,18,8,0
Joel Asoro,"FW,MF",Metz,fr Ligue 1,24,9.4,13,9,7,6,0,3,10,30.0,7,7,1,6,6,19,9,0
Iago Aspas,FW,Celta Vigo,es La Liga,35,30.1,11,6,4,6,1,1,15,6.7,14,23,3,20,10,21,8,0
Lorenz Assignon,DF,Burnley,eng Premier League,23,13.7,35,17,18,13,4,14,27,51.9,13,22,7,15,19,54,43,1
Lorenz Assignon,DF,Rennes,fr Ligue 1,23,11.2,24,12,12,8,4,9,24,37.5,15,9,4,5,9,33,27,1
Youcef Atal,DF,Nice,fr Ligue 1,27,4.0,9,3,6,2,1,6,8,75.0,2,7,1,6,4,13,1,0
Valentin Atangana Edoa,MF,Reims,fr Ligue 1,17,6.2,19,13,6,9,4,5,13,38.5,8,5,1,4,6,25,9,0
Arthur Atta,"MF,FW",Metz,fr Ligue 1,20,10.3,18,14,8,7,3,8,19,42.1,11,13,3,10,10,28,23,0
Noah Atubolu,GK,Freiburg,de Bundesliga,21,34.0,0,0,0,0,0,0,1,0.0,1,0,0,0,0,0,8,1
Pierre-Emerick Aubameyang,FW,Marseille,fr Ligue 1,34,29.1,22,14,4,11,7,7,26,26.9,19,30,5,25,9,31,26,0
Tommaso Augello,DF,Cagliari,it Serie A,28,26.9,26,19,18,6,2,16,25,64.0,9,21,10,11,17,43,89,0
Carlos Augusto,DF,Inter,it Serie A,24,19.2,29,21,20,9,0,15,22,68.2,7,20,8,12,16,45,52,0
Yann Aurel Bisseck,DF,Inter,it Serie A,22,10.0,14,6,10,3,1,6,9,66.7,3,10,7,3,5,19,23,0
Serge Aurier,"DF,MF",Nott'ham Forest,eng Premier League,30,9.3,20,14,9,11,0,5,11,45.5,6,10,3,7,9,29,36,1
Ezequiel Ávila,"FW,MF",Osasuna,es La Liga,29,9.6,3,2,1,1,1,3,11,27.3,8,14,0,14,4,7,8,0
Taiwo Awoniyi,FW,Nott'ham Forest,eng Premier League,25,11.6,9,7,1,4,4,1,2,50.0,1,7,2,5,1,10,9,0
André Ayew,FW,Le Havre,fr Ligue 1,33,12.3,15,11,7,6,2,6,9,66.7,3,8,3,5,2,17,11,0
Jordan Ayew,"FW,MF",Crystal Palace,eng Premier League,31,28.3,65,36,23,28,14,21,42,50.0,21,43,2,41,16,81,15,0
Neil El Aynaoui,MF,Lens,fr Ligue 1,22,17.4,37,20,13,20,4,20,46,43.5,26,20,6,14,32,69,21,1
Sardar Azmoun,"FW,MF",Roma,it Serie A,28,6.5,8,5,2,5,1,4,8,50.0,4,4,1,3,3,11,6,1
César Azpilicueta,DF,Atlético Madrid,es La Liga,33,15.8,25,14,15,9,1,12,19,63.2,7,25,6,19,16,41,46,0
Paulo Azzi,"DF,MF",Cagliari,it Serie A,29,10.6,19,11,10,6,3,9,18,50.0,9,11,2,9,16,35,23,0
Oussama El Azzouzi,MF,Bologna,it Serie A,22,6.1,12,7,4,5,3,7,14,50.0,7,8,2,6,6,18,12,0
Iddrisu Baba,MF,Almería,es La Liga,27,15.9,46,26,27,18,1,17,39,43.6,22,20,6,14,11,57,27,2
Shavy Babicka,"FW,MF",Toulouse,fr Ligue 1,23,4.1,11,8,2,7,2,2,5,40.0,3,6,1,5,0,11,2,0
Loïc Bade,DF,Sevilla,es La Liga,23,25.3,65,41,53,12,0,30,49,61.2,19,23,15,8,38,103,116,2
Milan Badelj,MF,Genoa,it Serie A,34,28.2,51,27,23,24,4,24,61,39.3,37,45,13,32,50,101,54,1
Matthias Bader,"DF,MF",Darmstadt 98,de Bundesliga,26,20.0,51,25,32,11,8,33,65,50.8,32,22,4,18,25,76,20,0
Benoît Badiashile,DF,Chelsea,eng Premier League,22,14.9,21,15,12,9,0,9,14,64.3,5,21,14,7,18,39,66,2
Alex Baena,"MF,FW",Villarreal,es La Liga,22,28.7,34,21,10,16,8,20,47,42.6,27,23,2,21,13,47,17,1
Jaime Báez,"FW,MF",Frosinone,it Serie A,28,5.6,4,1,0,2,2,0,7,0.0,7,5,0,5,4,8,1,0
Leon Bailey,"MF,FW",Aston Villa,eng Premier League,25,23.0,13,7,7,4,2,5,20,25.0,15,18,1,17,9,22,6,0
Eric Bailly,DF,Villarreal,es La Liga,29,9.3,5,3,4,1,0,2,2,100.0,0,8,8,0,9,14,38,2
Nedim Bajrami,"MF,FW",Sassuolo,it Serie A,24,14.6,13,6,6,3,4,5,13,38.5,8,5,1,4,6,19,8,0
Tiemoué Bakayoko,MF,Lorient,fr Ligue 1,28,14.6,34,17,14,17,3,15,28,53.6,13,10,4,6,26,60,15,1
Mitchel Bakker,DF,Atalanta,it Serie A,23,4.2,7,3,6,1,0,2,12,16.7,10,5,0,5,3,10,6,0
Ridle Baku,"DF,MF",Wolfsburg,de Bundesliga,25,22.4,37,20,24,7,6,21,46,45.7,25,27,1,26,21,58,45,1
Dilane Bakwa,"FW,MF",Strasbourg,fr Ligue 1,20,24.2,30,22,12,13,5,11,40,27.5,29,26,1,25,20,50,11,0
Tommaso Baldanzi,"MF,FW",Empoli,it Serie A,20,8.3,4,2,1,1,2,3,10,30.0,7,7,0,7,2,6,0,0
Tommaso Baldanzi,"FW,MF",Roma,it Serie A,20,5.8,9,5,3,4,2,1,1,100.0,0,2,0,2,0,9,4,0
Alejandro Balde,DF,Barcelona,es La Liga,19,15.3,20,11,11,6,3,7,11,63.6,4,14,1,13,5,25,21,1
George Baldock,DF,Sheffield Utd,eng Premier League,30,10.8,18,10,10,7,1,6,15,40.0,9,14,8,6,10,28,33,0
Carlos Baleba,MF,Brighton,eng Premier League,19,14.7,40,20,17,19,4,23,46,50.0,23,35,7,28,18,58,30,3
Leonardo Balerdi,DF,Marseille,fr Ligue 1,24,25.2,79,50,55,23,1,49,67,73.1,18,38,15,23,51,130,91,0
Iván Balliu,DF,Rayo Vallecano,es La Liga,31,31.9,44,31,20,24,0,22,39,56.4,17,27,11,16,29,73,66,1
Folarin Balogun,FW,Monaco,fr Ligue 1,22,18.8,12,4,3,8,1,5,13,38.5,8,10,0,10,3,15,4,0
Jonathan Bamba,"MF,FW",Celta Vigo,es La Liga,27,22.0,14,9,4,8,2,2,17,11.8,15,20,0,20,18,32,12,0
Mohamed Bamba,FW,Lorient,fr Ligue 1,21,12.6,14,9,3,8,3,4,10,40.0,6,7,1,6,2,16,3,0
Lameck Banda,FW,Lecce,it Serie A,22,15.0,27,23,11,12,4,7,21,33.3,14,18,0,18,3,30,7,0
Daniel Bandeira,MF,Hellas Verona,it Serie A,23,5.0,6,5,1,4,1,3,7,42.9,4,3,0,3,3,9,9,0
Mattia Bani,DF,Genoa,it Serie A,29,25.6,26,10,18,7,1,11,22,50.0,11,51,31,20,22,48,116,1
Léo Baptistão,FW,Almería,es La Liga,30,20.4,25,16,12,8,5,9,25,36.0,16,13,1,12,11,36,22,0
Antonín Barák,"MF,FW",Fiorentina,it Serie A,28,9.0,6,2,1,3,2,3,7,42.9,4,5,0,5,2,8,4,0
Bradley Barcola,"FW,MF",Paris S-G,fr Ligue 1,20,15.2,34,16,12,13,9,7,25,28.0,18,27,2,25,10,44,13,1
Melvin Bard,DF,Nice,fr Ligue 1,22,29.5,69,38,28,30,11,37,63,58.7,26,46,12,34,42,111,46,0
Nicolò Barella,MF,Inter,it Serie A,26,31.6,46,30,17,20,9,19,63,30.2,44,31,1,30,10,56,12,1
Ross Barkley,MF,Luton Town,eng Premier League,29,29.1,47,19,16,21,10,11,48,22.9,37,25,9,16,25,72,51,2
Harvey Barnes,"FW,MF",Newcastle Utd,eng Premier League,25,8.9,6,1,3,2,1,1,2,50.0,1,1,0,1,5,11,3,0
Leandro Barreiro Martins,MF,Mainz 05,de Bundesliga,23,29.0,65,40,19,37,9,30,50,60.0,20,45,16,29,36,101,53,0
Enzo Barrenechea,MF,Frosinone,it Serie A,22,31.2,65,42,28,29,8,28,70,40.0,42,47,12,35,27,92,61,2
Ander Barrenetxea,"FW,MF",Real Sociedad,es La Liga,21,15.9,32,21,7,16,9,10,26,38.5,16,18,1,17,6,38,5,0
Pablo Barrios,MF,Atlético Madrid,es La Liga,20,17.3,45,25,15,29,1,19,40,47.5,21,20,3,17,28,73,24,2
Federico Baschirotto,DF,Lecce,it Serie A,26,36.6,21,12,16,5,0,8,15,53.3,7,42,26,16,23,44,144,1
Toma Bašić,MF,Salernitana,it Serie A,26,12.9,20,13,10,9,1,10,27,37.0,17,18,6,12,14,34,29,0
Calvin Bassey,DF,Fulham,eng Premier League,23,25.6,49,29,33,15,1,21,29,72.4,8,32,11,21,28,77,84,4
Alessandro Bastoni,DF,Inter,it Serie A,24,25.2,46,33,31,12,3,26,40,65.0,14,25,11,14,23,69,48,1
Simone Bastoni,"MF,DF",Empoli,it Serie A,26,8.3,22,13,12,7,3,11,22,50.0,11,8,0,8,11,33,18,0
Augusto Batalla,GK,Granada,es La Liga,27,17.0,0,0,0,0,0,0,1,0.0,1,0,0,0,0,0,10,2
Daniel Batz,GK,Mainz 05,de Bundesliga,32,4.0,0,0,0,0,0,0,0,,0,0,0,0,0,0,3,0
Maximilian Bauer,DF,Augsburg,de Bundesliga,23,9.0,19,12,13,4,2,9,17,52.9,8,14,8,6,11,30,30,1
Oliver Baumann,GK,Hoffenheim,de Bundesliga,33,34.0,1,1,1,0,0,1,2,50.0,1,0,0,0,0,1,19,2
Christoph Baumgartner,"MF,FW",RB Leipzig,de Bundesliga,23,12.9,26,13,10,12,4,14,38,36.8,24,20,1,19,5,31,14,0
Ihlas Bebou,"FW,DF",Hoffenheim,de Bundesliga,29,18.2,22,12,10,8,4,8,16,50.0,8,13,2,11,14,36,15,0
Adrian Beck,"MF,FW",Heidenheim,de Bundesliga,26,10.8,22,13,8,12,2,9,24,37.5,15,17,0,17,4,26,15,0
Sheraldo Becker,"FW,MF",Real Sociedad,es La Liga,28,8.6,2,2,0,2,0,0,1,0.0,1,3,0,3,1,3,0,0
Sheraldo Becker,"FW,MF",Union Berlin,de Bundesliga,28,7.2,3,3,0,2,1,0,2,0.0,2,2,0,2,0,3,2,0
Donny van de Beek,"MF,FW",Eint Frankfurt,de Bundesliga,26,4.0,8,3,3,3,2,3,7,42.9,4,5,1,4,3,11,1,0
Kevin Behrens,FW,Wolfsburg,de Bundesliga,32,6.8,2,1,0,1,1,0,2,0.0,2,9,0,9,3,5,6,0
Kevin Behrens,FW,Union Berlin,de Bundesliga,32,14.0,13,10,3,7,3,1,4,25.0,3,7,2,5,6,19,19,0
Maximilian Beier,"FW,MF",Hoffenheim,de Bundesliga,20,26.9,20,12,5,11,4,4,19,21.1,15,21,1,20,9,29,12,0
Amari'i Bell,DF,Luton Town,eng Premier League,29,19.1,50,33,30,19,1,22,35,62.9,13,33,15,18,25,75,60,1
Stefan Bell,DF,Mainz 05,de Bundesliga,31,7.4,8,8,7,1,0,4,8,50.0,4,7,5,2,6,14,30,0
Alaa Bellaarouch,GK,Strasbourg,fr Ligue 1,21,15.0,0,0,0,0,0,0,0,,0,0,0,0,1,1,11,2
Raoul Bellanova,DF,Torino,it Serie A,23,33.8,36,26,15,17,4,18,31,58.1,13,21,4,17,15,51,36,3
Jean-Ricner Bellegarde,"MF,FW",Wolves,eng Premier League,25,10.6,17,10,9,6,2,7,15,46.7,8,18,2,16,8,25,14,0
Héctor Bellerín,DF,Betis,es La Liga,28,19.0,34,22,14,16,4,20,53,37.7,33,13,5,8,22,56,40,1
Jude Bellingham,MF,Real Madrid,es La Liga,20,25.7,42,34,14,18,10,12,36,33.3,24,55,5,50,21,63,17,0
Jeanuël Belocian,DF,Rennes,fr Ligue 1,18,16.1,32,22,23,8,1,22,28,78.6,6,18,10,8,13,45,49,0
Andrea Belotti,FW,Fiorentina,it Serie A,29,10.5,8,3,1,5,2,5,12,41.7,7,8,1,7,2,10,3,0
Andrea Belotti,FW,Roma,it Serie A,29,7.5,8,4,2,3,3,3,6,50.0,3,7,0,7,2,10,3,0
Fran Beltrán,MF,Celta Vigo,es La Liga,24,27.0,56,32,22,23,11,24,63,38.1,39,28,2,26,18,74,34,0
Lucas Beltrán,"FW,MF",Fiorentina,it Serie A,22,18.8,27,14,4,18,5,11,20,55.0,9,29,3,26,2,29,11,0
Eliesse Ben Seghir,"MF,FW",Monaco,fr Ligue 1,18,4.8,9,6,2,5,2,3,7,42.9,4,6,0,6,2,11,2,0
Anis Ben Slimane,MF,Sheffield Utd,eng Premier League,22,4.7,11,6,5,2,4,4,10,40.0,6,7,1,6,5,16,7,0
Wissam Ben Yedder,FW,Monaco,fr Ligue 1,32,25.7,4,3,1,2,1,1,11,9.1,10,18,0,18,8,12,1,0
Carlos Benavídez,MF,Alavés,es La Liga,25,12.6,56,35,19,26,11,19,34,55.9,15,13,5,8,19,75,31,0
Ismaël Bennacer,MF,Milan,it Serie A,25,12.8,29,19,11,16,2,11,22,50.0,11,12,4,8,12,41,9,2
Saïd Benrahma,"FW,MF",West Ham,eng Premier League,27,6.9,8,4,5,3,0,4,15,26.7,11,8,0,8,5,13,7,0
Saïd Benrahma,"FW,MF",Lyon,fr Ligue 1,27,8.6,9,7,1,6,2,5,7,71.4,2,7,0,7,1,10,3,0
Ramy Bensebaini,DF,Dortmund,de Bundesliga,28,11.5,34,21,21,11,2,24,34,70.6,10,22,7,15,16,50,37,0
Nabil Bentaleb,MF,Lille,fr Ligue 1,28,21.9,49,32,29,18,2,22,43,51.2,21,33,12,21,37,86,33,0
Rodrigo Bentancur,MF,Tottenham,eng Premier League,26,11.2,23,15,10,11,2,10,24,41.7,14,15,4,11,17,40,16,1
Daniel Bentley,GK,Wolves,eng Premier League,30,4.3,0,0,0,0,0,0,1,0.0,1,0,0,0,0,0,1,0
Lucas Beraldo,DF,Paris S-G,fr Ligue 1,19,11.2,22,14,14,8,0,10,25,40.0,15,15,6,9,20,42,25,0
Domenico Berardi,FW,Sassuolo,it Serie A,28,15.9,17,8,7,9,1,2,21,9.5,19,17,0,17,13,30,9,0
Yuri Berchiche,DF,Athletic Club,es La Liga,33,21.4,33,25,13,14,6,19,33,57.6,14,28,9,19,20,53,62,0
Álex Berenguer,FW,Athletic Club,es La Liga,28,17.7,23,14,9,9,5,7,24,29.2,17,23,0,23,5,28,13,0
Bartosz Bereszyński,DF,Empoli,it Serie A,31,19.6,41,25,25,13,3,24,40,60.0,16,22,10,12,21,62,52,0
Jóhann Berg Guðmundsson,"MF,FW",Burnley,eng Premier League,32,13.2,13,4,6,5,2,7,16,43.8,9,14,0,14,16,29,16,0
Sander Berge,MF,Burnley,eng Premier League,25,33.4,76,46,35,36,5,34,58,58.6,24,49,20,29,23,99,60,2
Etrit Berisha,GK,Empoli,it Serie A,34,14.0,0,0,0,0,0,0,1,0.0,1,0,0,0,0,0,7,1
Isaac Bernal,FW,Sevilla,es La Liga,23,11.5,6,3,2,2,2,5,9,55.6,4,12,0,12,0,6,11,0
Bernardo,DF,Bochum,de Bundesliga,28,32.5,99,58,56,35,8,45,69,65.2,24,66,30,36,55,154,120,1
Victor Bernth Kristiansen,DF,Bologna,it Serie A,20,25.6,52,34,23,22,7,20,35,57.1,15,35,8,27,12,64,45,1
Matúš Bero,"MF,FW",Bochum,de Bundesliga,27,18.5,32,22,13,12,7,13,32,40.6,19,24,3,21,12,44,26,0
Dimitry Bertaud,GK,Montpellier,fr Ligue 1,25,4.0,0,0,0,0,0,0,0,,0,0,0,0,0,0,0,0
Jan-Niklas Beste,"FW,MF",Heidenheim,de Bundesliga,24,28.9,77,49,35,24,18,28,55,50.9,27,48,1,47,18,95,31,0
Beto,FW,Everton,eng Premier League,25,10.6,14,6,1,6,7,4,12,33.3,8,11,0,11,1,15,14,0
Sam Beukema,DF,Bologna,it Serie A,24,28.3,27,11,14,11,2,16,25,64.0,9,35,21,14,15,42,99,2
Jordan Beyer,DF,Burnley,eng Premier League,23,13.7,35,20,22,12,1,14,24,58.3,10,22,15,7,16,51,68,1
Jaka Bijol,DF,Udinese,it Serie A,24,23.2,43,27,34,9,0,22,35,62.9,13,36,21,15,23,66,140,1
El Bilal Touré,FW,Atalanta,it Serie A,21,4.4,1,1,0,1,0,0,1,0.0,1,0,0,0,1,2,2,0
Philip Billing,MF,Bournemouth,eng Premier League,27,15.5,33,16,7,22,4,9,27,33.3,18,31,5,26,20,53,28,1
Cristiano Biraghi,DF,Fiorentina,it Serie A,30,26.2,47,28,20,24,3,28,52,53.8,24,30,5,25,14,61,43,0
Samuele Birindelli,DF,Monza,it Serie A,24,22.4,28,19,16,7,5,14,25,56.0,11,30,11,19,18,46,48,0
Yves Bissouma,MF,Tottenham,eng Premier League,26,23.0,80,52,32,36,12,41,61,67.2,20,28,5,23,37,117,43,3
Leonardo Bittencourt,MF,Werder Bremen,de Bundesliga,29,17.5,42,18,20,17,5,15,39,38.5,24,18,1,17,13,55,6,0
Marco Bizot,GK,Brest,fr Ligue 1,32,32.0,0,0,0,0,0,0,1,0.0,1,0,0,0,0,0,18,3
Antonio Blanco,MF,Alavés,es La Liga,23,27.0,61,36,29,27,5,31,86,36.0,55,25,2,23,35,96,30,0
Ludovic Blas,"FW,MF",Rennes,fr Ligue 1,25,17.4,30,14,16,13,1,12,28,42.9,16,13,1,12,6,36,9,0
Janis Blaswich,GK,RB Leipzig,de Bundesliga,32,21.0,1,1,1,0,0,0,0,,0,0,0,0,0,1,7,3
Alexis Blin,MF,Lecce,it Serie A,26,18.2,33,19,11,19,3,15,43,34.9,28,16,2,14,22,55,39,0
Daley Blind,DF,Girona,es La Liga,33,33.0,47,21,33,13,1,29,47,61.7,18,37,19,18,21,68,113,0
Jeremie Boga,FW,Nice,fr Ligue 1,26,22.2,18,7,6,10,2,10,20,50.0,10,26,2,24,8,26,4,0
Jayden Bogle,DF,Sheffield Utd,eng Premier League,23,31.0,66,36,43,21,2,35,70,50.0,35,42,11,31,32,98,97,0
Emil Bohinen,MF,Salernitana,it Serie A,24,5.9,8,6,5,3,0,2,10,20.0,8,8,2,6,14,22,6,1
Daniel Boloca,MF,Sassuolo,it Serie A,24,22.5,48,33,18,25,5,27,46,58.7,19,23,13,10,14,62,33,2
Willy Boly,DF,Nott'ham Forest,eng Premier League,32,16.0,46,29,36,9,1,22,40,55.0,18,32,21,11,25,71,90,0
Giacomo Bonaventura,MF,Fiorentina,it Serie A,33,25.3,26,13,6,10,10,9,21,42.9,12,16,1,15,14,40,10,0
Federico Bonazzoli,"FW,MF",Hellas Verona,it Serie A,26,11.3,4,1,1,3,0,1,8,12.5,7,9,1,8,3,7,3,0
Warren Bondo,MF,Monza,it Serie A,19,16.4,29,22,16,10,3,13,17,76.5,4,13,3,10,6,35,13,0
Victor Boniface,FW,Leverkusen,de Bundesliga,22,17.2,6,4,0,1,5,1,4,25.0,3,6,1,5,0,6,13,0
Leonardo Bonucci,DF,Union Berlin,de Bundesliga,36,5.1,6,5,2,4,0,4,4,100.0,0,5,3,2,7,13,16,0
Ângelo Borges,"FW,MF",Strasbourg,fr Ligue 1,18,12.2,24,11,9,7,8,11,31,35.5,20,18,0,18,9,33,2,0
Neto Borges,DF,Clermont Foot,fr Ligue 1,26,28.0,48,24,25,18,5,28,63,44.4,35,28,6,22,57,105,84,0
Sebastiaan Bornauw,DF,Wolfsburg,de Bundesliga,24,15.9,26,12,19,7,0,13,19,68.4,6,21,12,9,18,44,81,0
Rafael Borré,FW,Werder Bremen,de Bundesliga,27,11.0,10,7,2,4,4,5,16,31.3,11,8,2,6,2,12,10,0
Sven Botman,DF,Newcastle Utd,eng Premier League,23,15.3,20,13,14,6,0,8,13,61.5,5,20,16,4,9,29,61,3
Badredine Bouanani,MF,Lorient,fr Ligue 1,18,4.9,4,2,1,1,2,2,4,50.0,2,3,0,3,2,6,3,0
Hicham Boudaoui,MF,Nice,fr Ligue 1,23,17.9,41,19,16,22,3,21,30,70.0,9,15,1,14,11,52,15,0
Benjamin Bourigeaud,"MF,FW",Rennes,fr Ligue 1,29,26.9,31,18,14,9,8,13,44,29.5,31,31,2,29,22,53,39,2
Bilal Boutobba,"FW,MF",Clermont Foot,fr Ligue 1,24,10.3,22,12,6,10,6,10,23,43.5,13,9,0,9,8,30,3,0
Edoardo Bove,MF,Roma,it Serie A,21,19.8,60,31,16,31,13,27,46,58.7,19,21,1,20,11,71,11,1
Jarrod Bowen,FW,West Ham,eng Premier League,26,33.5,42,28,14,14,14,13,35,37.1,22,37,5,32,19,61,14,0
Lucas Boyé,FW,Granada,es La Liga,27,28.2,50,25,14,25,11,14,34,41.2,20,35,5,30,10,60,46,0
Domagoj Bradarić,DF,Salernitana,it Serie A,23,30.5,29,20,13,10,6,15,25,60.0,10,22,7,15,32,61,62,1
Conor Bradley,DF,Liverpool,eng Premier League,20,8.4,33,25,14,12,7,24,38,63.2,14,17,1,16,10,43,14,0
Juan Brandáriz,DF,Almería,es La Liga,24,27.0,34,22,22,12,0,16,26,61.5,10,38,23,15,14,48,107,3
Julian Brandt,"MF,FW",Dortmund,de Bundesliga,27,24.7,17,14,8,8,1,10,27,37.0,17,20,3,17,8,25,18,0
Jarrad Branthwaite,DF,Everton,eng Premier League,21,34.6,66,32,42,22,2,45,62,72.6,17,51,36,15,50,116,163,2
Lilian Brassier,DF,Brest,fr Ligue 1,23,29.7,31,18,18,13,0,12,24,50.0,12,28,21,7,41,72,93,0
Claudio Bravo,GK,Betis,es La Liga,40,7.0,0,0,0,0,0,0,1,0.0,1,0,0,0,0,0,2,0
Fabian Bredlow,GK,Stuttgart,de Bundesliga,28,4.0,0,0,0,0,0,0,1,0.0,1,0,0,0,0,0,3,0
Tim Breithaupt,MF,Augsburg,de Bundesliga,21,7.0,20,11,11,9,0,13,21,61.9,8,15,3,12,8,28,10,0
Josip Brekalo,FW,Fiorentina,it Serie A,25,7.2,8,6,6,2,0,2,11,18.2,9,7,0,7,1,9,0,0
Gleison Bremer,DF,Juventus,it Serie A,26,35.9,58,42,32,21,5,21,29,72.4,8,45,27,18,40,98,147,0
Ben Brereton,"FW,MF",Sheffield Utd,eng Premier League,24,12.3,9,4,4,4,1,4,10,40.0,6,9,3,6,3,12,12,0
Marco Brescianini,MF,Frosinone,it Serie A,23,25.8,28,13,13,12,3,9,25,36.0,16,22,5,17,10,38,37,0
Armando Broja,FW,Chelsea,eng Premier League,21,5.0,3,0,0,1,2,1,2,50.0,1,5,1,4,0,3,3,0
Andre Brooks,"MF,DF",Sheffield Utd,eng Premier League,19,10.4,22,13,7,11,4,9,21,42.9,12,13,1,12,14,36,20,0
John Brooks,DF,Hoffenheim,de Bundesliga,30,17.1,28,15,17,10,1,15,30,50.0,15,29,17,12,27,55,109,1
Moritz Broschinski,FW,Bochum,de Bundesliga,22,13.9,11,7,2,5,4,2,8,25.0,6,11,2,9,0,11,6,0
Jacob Brown,"MF,FW",Luton Town,eng Premier League,25,11.3,19,12,7,7,5,7,18,38.9,11,20,1,19,8,27,22,0
Josh Brownhill,MF,Burnley,eng Premier League,27,25.0,61,35,23,28,10,27,37,73.0,10,33,8,25,34,95,40,1
Jacob Bruun Larsen,"MF,FW",Burnley,eng Premier League,24,13.9,9,4,4,3,2,7,21,33.3,14,16,2,14,7,16,23,0
Ante Budimir,FW,Osasuna,es La Liga,32,27.1,21,15,2,11,8,5,14,35.7,9,19,5,14,5,26,18,0
Hugo Bueno,"DF,MF",Wolves,eng Premier League,20,8.2,21,14,12,7,2,12,19,63.2,7,17,4,13,6,27,24,0
Santiago Bueno,DF,Wolves,eng Premier League,24,9.1,13,7,5,7,1,5,11,45.5,6,22,12,10,6,19,33,0
Marius Bülter,"DF,FW",Hoffenheim,de Bundesliga,30,15.0,18,11,9,5,4,12,23,52.2,11,17,3,14,10,28,20,0
Facundo Buonanotte,"FW,MF",Brighton,eng Premier League,18,15.2,42,22,13,22,7,14,44,31.8,30,22,3,19,8,50,5,0
Alessandro Buongiorno,DF,Torino,it Serie A,24,28.1,70,39,43,24,3,24,34,70.6,10,20,12,8,69,139,131,0
Jonathan Burkardt,"FW,MF",Mainz 05,de Bundesliga,23,17.1,12,8,2,6,4,4,11,36.4,7,16,3,13,3,15,2,0
Reece Burke,DF,Luton Town,eng Premier League,26,18.4,37,23,17,14,6,12,26,46.2,14,25,18,7,18,55,78,1
Dan Burn,DF,Newcastle Utd,eng Premier League,31,30.3,61,33,37,20,4,26,61,42.6,35,55,25,30,37,98,124,1
Marnon Busch,DF,Heidenheim,de Bundesliga,28,6.6,11,9,6,3,2,7,12,58.3,5,9,2,7,10,21,12,0
Aurélio Buta,"DF,MF",Eint Frankfurt,de Bundesliga,26,19.4,40,25,19,16,5,21,38,55.3,17,24,5,19,15,55,36,0
Marcin Bułka,GK,Nice,fr Ligue 1,23,34.0,0,0,0,0,0,0,2,0.0,2,0,0,0,0,0,9,3
Rémy Cabella,"FW,MF",Lille,fr Ligue 1,33,16.4,54,36,19,20,15,20,54,37.0,34,32,0,32,5,59,5,0
Jovane Cabral,"MF,FW",Salernitana,it Serie A,25,7.5,13,9,4,7,2,3,9,33.3,6,3,0,3,1,14,4,0
Liberato Cacace,DF,Empoli,it Serie A,22,21.2,40,24,24,13,3,24,38,63.2,14,23,6,17,19,59,56,0
Anthony Caci,DF,Mainz 05,de Bundesliga,26,27.6,56,23,30,25,1,27,44,61.4,17,43,7,36,32,88,45,0
Moisés Caicedo,MF,Chelsea,eng Premier League,21,31.8,91,46,38,42,11,36,60,60.0,24,59,25,34,37,128,44,4
Tom Cairney,MF,Fulham,eng Premier League,32,16.5,24,16,10,12,2,13,25,52.0,12,16,4,12,13,37,6,0
Jens Cajuste,MF,Napoli,it Serie A,23,11.3,36,24,13,17,6,20,37,54.1,17,20,3,17,4,40,15,0
Davide Calabria,DF,Milan,it Serie A,26,24.3,70,38,38,25,7,44,72,61.1,28,26,7,19,24,94,49,1
Riccardo Calafiori,DF,Bologna,it Serie A,21,26.1,47,32,28,16,3,22,32,68.8,10,38,13,25,50,97,74,3
Luca Caldirola,DF,Monza,it Serie A,32,23.8,25,14,19,4,2,13,22,59.1,9,26,17,9,29,54,53,0
Duje Ćaleta-Car,DF,Lyon,fr Ligue 1,26,22.1,26,11,19,6,1,18,22,81.8,4,27,14,13,18,44,94,1
Hakan Çalhanoğlu,MF,Inter,it Serie A,29,28.4,66,33,29,29,8,32,49,65.3,17,29,13,16,24,90,22,0
José Callejón,"MF,FW",Granada,es La Liga,36,8.9,13,6,10,3,0,8,22,36.4,14,7,1,6,5,18,10,0
Dominic Calvert-Lewin,FW,Everton,eng Premier League,26,24.1,13,6,2,6,5,2,15,13.3,13,14,4,10,4,17,38,0
Lamine Camara,MF,Metz,fr Ligue 1,19,25.1,62,42,26,30,6,24,49,49.0,25,35,2,33,28,90,34,0
Mahdi Camara,MF,Brest,fr Ligue 1,25,22.4,55,39,8,40,7,20,49,40.8,29,24,1,23,27,82,19,0
Mohamed Camara,MF,Monaco,fr Ligue 1,23,11.5,35,21,10,20,5,15,29,51.7,14,8,2,6,11,46,7,0
Eduardo Camavinga,"MF,DF",Real Madrid,es La Liga,20,20.2,76,47,39,29,8,23,39,59.0,16,36,8,28,29,105,29,1
Nicolò Cambiaghi,"FW,MF",Empoli,it Serie A,22,28.4,51,39,15,20,16,16,35,45.7,19,26,1,25,14,65,8,0
Andrea Cambiaso,"DF,FW",Juventus,it Serie A,23,26.4,47,30,23,15,9,25,43,58.1,18,28,3,25,11,58,26,1
Sergio Camello,FW,Rayo Vallecano,es La Liga,22,18.5,16,5,3,10,3,6,15,40.0,9,10,2,8,3,19,15,0
Emre Can,"MF,DF",Dortmund,de Bundesliga,29,21.7,63,45,37,23,3,28,48,58.3,20,30,7,23,22,85,41,2
Matteo Cancellieri,"FW,MF",Empoli,it Serie A,21,19.9,35,22,12,16,7,13,36,36.1,23,19,0,19,6,41,18,0
João Cancelo,DF,Barcelona,es La Liga,29,27.8,64,44,35,21,8,38,58,65.5,20,35,6,29,29,93,59,1
Fali Candé,DF,Metz,fr Ligue 1,25,20.5,40,19,31,9,0,20,35,57.1,15,41,28,13,20,60,107,1
Antonio Candreva,"MF,FW",Salernitana,it Serie A,36,30.6,18,13,8,8,2,9,25,36.0,16,9,0,9,7,25,23,0
Sergi Canós,"MF,FW",Valencia,es La Liga,26,13.7,23,13,7,11,5,10,24,41.7,14,14,2,12,11,34,9,0
Étienne Capoue,MF,Villarreal,es La Liga,35,16.2,32,18,17,12,3,15,22,68.2,7,20,4,16,22,54,24,1
Elia Caprile,GK,Empoli,it Serie A,21,23.0,1,0,1,0,0,1,1,100.0,0,0,0,0,0,1,16,2
Francesco Caputo,FW,Empoli,it Serie A,35,14.1,2,0,0,0,2,0,1,0.0,1,4,0,4,1,3,3,0
Maxence Caqueret,MF,Lyon,fr Ligue 1,23,33.6,91,64,39,37,15,38,107,35.5,69,40,9,31,48,139,26,2
Andrea Carboni,DF,Monza,it Serie A,22,16.5,38,22,24,12,2,20,31,64.5,11,23,13,10,17,55,56,1
Valentin Carboni,"MF,FW",Monza,it Serie A,18,13.0,25,15,10,12,3,8,26,30.8,18,12,1,11,7,32,4,0
Isaac Carcelen,DF,Cádiz,es La Liga,30,29.0,50,31,30,15,5,25,45,55.6,20,24,7,17,27,77,87,2
Marc Cardona,FW,Las Palmas,es La Liga,28,8.0,9,8,3,4,2,1,12,8.3,11,5,0,5,2,11,7,0
Sergi Cardona,DF,Las Palmas,es La Liga,24,31.3,90,55,52,29,9,55,96,57.3,41,45,7,38,46,136,102,0
Johnny Cardoso,MF,Betis,es La Liga,21,14.8,48,29,19,24,5,22,33,66.7,11,20,5,15,32,80,31,0
Diego Carlos,DF,Aston Villa,eng Premier League,30,20.2,27,16,22,4,1,13,21,61.9,8,24,19,5,13,40,78,3
Carmona,"DF,MF",Getafe,es La Liga,21,14.6,30,21,13,14,3,9,28,32.1,19,15,2,13,21,51,25,0
Marco Carnesecchi,GK,Atalanta,it Serie A,23,26.9,0,0,0,0,0,0,0,,0,0,0,0,0,0,22,3
Álvaro Carreras,"MF,FW",Granada,es La Liga,20,5.3,13,8,8,4,1,5,11,45.5,6,5,1,4,7,20,9,1
Rasmus Carstensen,"DF,FW",Köln,de Bundesliga,22,18.4,47,22,23,20,4,31,56,55.4,25,38,9,29,20,67,50,2
Dani Carvajal,DF,Real Madrid,es La Liga,31,24.1,47,32,28,15,4,23,42,54.8,19,28,9,19,22,69,54,4
William Carvalho,MF,Betis,es La Liga,31,7.6,20,12,11,7,2,10,16,62.5,6,8,1,7,8,28,9,1
Nicolò Casale,DF,Lazio,it Serie A,25,17.3,15,9,13,2,0,6,15,40.0,9,19,16,3,12,27,61,0
Casemiro,"MF,DF",Manchester Utd,eng Premier League,31,22.0,83,56,43,32,8,51,106,48.1,55,74,33,41,18,101,71,1
Matty Cash,DF,Aston Villa,eng Premier League,25,23.8,54,31,24,24,6,29,59,49.2,30,35,14,21,18,72,59,0
Josué Casimir,"FW,DF",Le Havre,fr Ligue 1,21,22.4,31,18,14,14,3,7,18,38.9,11,23,2,21,13,44,25,0
Giuseppe Caso,"FW,MF",Frosinone,it Serie A,24,4.6,4,3,2,0,2,2,3,66.7,1,0,0,0,0,4,0,0
Cristian Cásseres Jr.,MF,Toulouse,fr Ligue 1,23,21.6,70,34,31,33,6,29,61,47.5,32,34,4,30,27,97,33,1
Timothy Castagne,DF,Fulham,eng Premier League,27,29.3,49,24,23,16,10,26,44,59.1,18,38,10,28,38,87,69,1
Koen Casteels,GK,Wolfsburg,de Bundesliga,31,25.0,2,1,2,0,0,2,3,66.7,1,0,0,0,0,2,16,5
Valentín Castellanos,FW,Lazio,it Serie A,24,18.7,22,10,1,12,9,6,20,30.0,14,22,2,20,2,24,18,0
Jean-Charles Castelletto,DF,Nantes,fr Ligue 1,28,27.4,34,26,22,10,2,18,29,62.1,11,19,10,9,32,66,81,0
Samu Castillejo,"FW,MF",Sassuolo,it Serie A,28,6.0,12,10,5,5,2,7,19,36.8,12,16,1,15,1,13,3,0
Gaetano Castrovilli,"FW,MF",Fiorentina,it Serie A,26,4.1,3,2,1,2,0,1,8,12.5,7,4,0,4,2,5,3,0
Danilo Cataldi,MF,Lazio,it Serie A,28,15.1,24,12,7,16,1,8,18,44.4,10,15,7,8,17,41,19,1
Catena,DF,Osasuna,es La Liga,28,28.2,33,18,26,6,1,19,35,54.3,16,24,15,9,15,48,119,3
Maximiliano Caufriez,DF,Clermont Foot,fr Ligue 1,26,18.4,38,28,31,5,2,19,29,65.5,10,18,12,6,18,56,69,2
Ivan Cavaleiro,FW,Lille,fr Ligue 1,29,8.6,10,6,3,4,3,7,20,35.0,13,9,2,7,5,15,6,0
Dani Ceballos,"MF,FW",Real Madrid,es La Liga,26,6.6,10,5,4,5,1,5,14,35.7,9,9,2,7,0,10,4,1
Zeki Çelik,DF,Roma,it Serie A,26,7.5,23,16,10,10,3,14,25,56.0,11,12,5,7,8,31,25,0
Álex Centelles,DF,Almería,es La Liga,25,10.9,11,6,9,2,0,8,18,44.4,10,5,2,3,18,29,29,0
Fabien Centonze,DF,Hellas Verona,it Serie A,27,7.5,14,8,10,4,0,5,10,50.0,5,14,2,12,10,24,18,0
Václav Černý,"FW,MF",Wolfsburg,de Bundesliga,25,10.2,8,3,3,4,1,2,14,14.3,12,13,0,13,8,16,6,0
Michele Cerofolini,GK,Frosinone,it Serie A,24,7.5,0,0,0,0,0,0,0,,0,0,0,0,0,0,5,1
Alberto Cerri,FW,Empoli,it Serie A,27,6.1,3,3,1,1,1,2,5,40.0,3,3,1,2,3,6,7,0
Franco Cervi,"MF,DF",Celta Vigo,es La Liga,29,6.1,24,18,13,9,2,13,24,54.2,11,16,0,16,9,33,4,0
Julian Chabot,DF,Köln,de Bundesliga,25,30.0,59,42,40,17,2,35,59,59.3,24,66,43,23,45,104,145,0
Fares Chaïbi,"MF,FW",Eint Frankfurt,de Bundesliga,20,21.2,27,17,7,12,8,8,18,44.4,10,37,1,36,5,32,19,0
Trevoh Chalobah,DF,Chelsea,eng Premier League,24,10.6,16,12,10,2,4,10,15,66.7,5,8,7,1,8,24,51,0
Muhammed Cham,"MF,FW",Clermont Foot,fr Ligue 1,22,28.4,25,14,10,13,2,11,27,40.7,16,20,2,18,8,33,5,1
Brendan Chardonnet,DF,Brest,fr Ligue 1,28,33.0,57,34,33,22,2,32,63,50.8,31,58,34,24,53,110,139,3
Pep Chavarría,"DF,MF",Rayo Vallecano,es La Liga,25,13.0,23,18,15,6,2,11,17,64.7,6,15,3,12,6,29,29,1
Jhoanner Chávez,DF,Lens,fr Ligue 1,21,5.3,6,5,2,2,2,3,9,33.3,6,2,0,2,5,11,11,0
Walid Cheddira,FW,Frosinone,it Serie A,25,23.6,12,7,1,8,3,4,8,50.0,4,6,1,5,5,17,10,0
Rayan Cherki,"MF,FW",Lyon,fr Ligue 1,19,19.1,28,15,4,16,8,17,46,37.0,29,13,3,10,7,35,1,0
Lucas Chevalier,GK,Lille,fr Ligue 1,21,33.0,3,0,3,0,0,3,4,75.0,1,1,0,1,0,3,11,2
Federico Chiesa,FW,Juventus,it Serie A,25,24.4,20,10,7,6,7,3,13,23.1,10,17,1,16,6,26,4,0
Ben Chilwell,DF,Chelsea,eng Premier League,26,8.4,15,10,5,9,1,5,8,62.5,3,11,3,8,4,19,19,1
Pedro Chirivella,MF,Nantes,fr Ligue 1,26,28.8,50,28,20,29,1,30,76,39.5,46,22,5,17,31,81,28,0
Tahith Chong,"MF,FW",Luton Town,eng Premier League,23,22.0,36,22,19,13,4,15,33,45.5,18,30,6,24,8,44,11,1
Joris Chotard,MF,Montpellier,fr Ligue 1,21,28.7,81,52,45,25,11,48,96,50.0,48,47,21,26,44,125,60,0
Andreas Christensen,"DF,MF",Barcelona,es La Liga,27,22.0,23,14,7,14,2,16,28,57.1,12,23,10,13,21,44,41,0
Oliver Christensen,GK,Fiorentina,it Serie A,24,4.0,0,0,0,0,0,0,0,,0,0,0,0,0,0,1,0
Ryan Christie,MF,Bournemouth,eng Premier League,28,32.3,86,44,34,35,17,39,92,42.4,53,52,11,41,52,138,53,1
Samuel Chukwueze,FW,Milan,it Serie A,24,11.3,18,7,11,5,2,9,17,52.9,8,3,1,2,6,24,3,0
Víctor Chust,DF,Cádiz,es La Liga,23,20.7,29,18,23,5,1,18,32,56.3,14,27,21,6,11,40,92,1
Pathé Ciss,MF,Rayo Vallecano,es La Liga,29,18.5,44,24,16,26,2,16,29,55.2,13,27,10,17,30,74,54,0
Patrick Ciurria,"DF,MF",Monza,it Serie A,28,17.8,30,18,13,13,4,13,21,61.9,8,20,5,15,9,39,28,0
Jordan Clark,MF,Luton Town,eng Premier League,29,14.5,30,17,14,11,5,11,39,28.2,28,24,3,21,11,41,15,1
Alexis Claude-Maurice,MF,Nice,fr Ligue 1,25,5.6,12,5,3,6,3,1,5,20.0,4,4,1,3,5,17,7,0
Jonathan Clauss,DF,Marseille,fr Ligue 1,30,23.0,47,20,22,19,6,26,49,53.1,23,17,3,14,36,83,46,0
Nathaniel Clyne,DF,Crystal Palace,eng Premier League,32,14.9,24,15,11,11,2,14,21,66.7,7,18,6,12,10,34,33,0
Marcus Coco,"DF,FW",Nantes,fr Ligue 1,27,16.5,43,26,29,10,4,28,60,46.7,32,19,1,18,21,64,38,0
Saúl Coco,DF,Las Palmas,es La Liga,24,25.5,32,19,25,7,0,11,18,61.1,7,27,15,12,20,52,120,3
Séamus Coleman,DF,Everton,eng Premier League,34,7.4,17,14,10,3,4,11,16,68.8,5,12,4,8,7,24,26,1
Maxime Colin,DF,Metz,fr Ligue 1,31,20.4,39,23,25,7,7,16,29,55.2,13,22,7,15,20,59,71,0
Nathan Collins,DF,Brentford,eng Premier League,22,29.5,38,20,24,12,2,19,29,65.5,10,46,30,16,44,82,141,4
Lorenzo Colombo,FW,Monza,it Serie A,21,15.1,17,12,3,9,5,8,14,57.1,6,18,5,13,0,17,14,0
Andrea Colpani,"MF,FW",Monza,it Serie A,24,29.5,25,15,6,13,6,11,20,55.0,9,11,4,7,14,39,14,0
Levi Colwill,DF,Chelsea,eng Premier League,20,20.0,48,30,26,17,5,26,34,76.5,8,28,10,18,26,74,66,0
Kingsley Coman,FW,Bayern Munich,de Bundesliga,27,12.4,12,7,5,3,4,9,17,52.9,8,15,1,14,2,14,5,0
Eray Cömert,DF,Nantes,fr Ligue 1,25,22.2,42,28,28,13,1,28,38,73.7,10,35,18,17,36,78,77,1
Santi Comesaña,MF,Villarreal,es La Liga,26,18.4,44,26,15,21,8,19,38,50.0,19,33,9,24,22,66,27,1
Andrea Consigli,GK,Sassuolo,it Serie A,36,35.0,0,0,0,0,0,0,0,,0,1,0,1,1,1,19,1
Lewis Cook,MF,Bournemouth,eng Premier League,26,31.0,61,41,24,30,7,34,63,54.0,29,32,11,21,65,126,46,1
Copete,DF,Mallorca,es La Liga,23,14.8,45,27,27,17,1,30,43,69.8,13,12,6,6,32,77,47,1
Diego Coppola,DF,Hellas Verona,it Serie A,19,18.2,36,22,25,9,2,20,33,60.6,13,26,9,17,27,63,89,1
Francis Coquelin,MF,Villarreal,es La Liga,32,10.1,20,12,8,10,2,5,13,38.5,8,14,4,10,16,36,15,0
Ángel Correa,"FW,MF",Atlético Madrid,es La Liga,28,17.0,22,15,3,11,8,5,17,29.4,12,13,0,13,2,24,6,0
Joaquín Correa,"FW,MF",Marseille,fr Ligue 1,28,4.8,7,5,4,2,1,0,8,0.0,8,2,0,2,1,8,1,0
Thierry Correia,DF,Valencia,es La Liga,24,23.9,63,35,39,20,4,28,49,57.1,21,39,16,23,33,96,61,0
Danny da Costa,DF,Mainz 05,de Bundesliga,30,9.2,18,9,9,7,2,9,19,47.4,10,17,4,13,16,34,24,0
David Pereira da Costa,MF,Lens,fr Ligue 1,22,16.6,18,10,5,12,1,10,23,43.5,13,21,4,17,16,34,8,1
Jaume Costa,DF,Mallorca,es La Liga,35,18.7,38,22,23,10,5,18,29,62.1,11,14,4,10,16,54,35,0
Logan Costa,DF,Toulouse,fr Ligue 1,22,29.4,40,24,31,9,0,15,24,62.5,9,42,27,15,23,63,120,1
Samu Costa,MF,Mallorca,es La Liga,22,25.6,91,50,40,46,5,46,93,49.5,47,28,14,14,39,130,59,3
Benoît Costil,GK,Salernitana,it Serie A,36,13.0,2,1,1,1,0,2,3,66.7,1,0,0,0,0,2,5,1
Vladimír Coufal,DF,West Ham,eng Premier League,30,34.8,64,41,50,12,2,38,75,50.7,37,49,15,34,43,107,97,0
Lassana Coulibaly,MF,Salernitana,it Serie A,27,23.1,47,32,20,21,6,22,49,44.9,27,23,5,18,16,63,29,0
Tanguy Coulibaly,"FW,MF",Montpellier,fr Ligue 1,22,6.9,13,11,8,4,1,4,9,44.4,5,11,1,10,2,15,2,0
Yan Couto,"DF,FW",Girona,es La Liga,21,24.9,45,34,25,14,6,20,40,50.0,20,14,2,12,10,55,31,1
Nicolas Cozza,DF,Nantes,fr Ligue 1,24,9.9,35,23,23,10,2,17,24,70.8,7,7,0,7,14,49,32,0
Crespo,MF,Rayo Vallecano,es La Liga,26,5.9,16,9,8,6,2,9,17,52.9,8,15,6,9,10,26,7,0
Aaron Cresswell,"DF,FW",West Ham,eng Premier League,33,4.8,3,2,1,1,1,2,3,66.7,1,5,3,2,3,6,7,0
Bryan Cristante,"MF,DF",Roma,it Serie A,28,36.5,72,41,33,28,11,28,50,56.0,22,36,6,30,25,97,55,2
Juan Cruz Armada,DF,Osasuna,es La Liga,31,18.5,27,15,16,10,1,17,25,68.0,8,14,7,7,12,39,39,1
Pau Cubarsí,DF,Barcelona,es La Liga,16,17.3,22,14,18,3,1,13,18,72.2,5,20,16,4,12,34,65,0
Marc Cucurella,DF,Chelsea,eng Premier League,25,19.8,62,38,36,21,5,34,64,53.1,30,36,13,23,22,84,48,0
Jorge Cuenca,DF,Villarreal,es La Liga,23,21.8,42,29,26,10,6,19,30,63.3,11,26,15,11,21,63,114,0
Josh Cullen,MF,Burnley,eng Premier League,27,22.9,42,29,15,22,5,26,46,56.5,20,31,19,12,15,57,26,1
Matheus Cunha,"FW,MF",Wolves,eng Premier League,24,27.1,30,16,8,17,5,13,35,37.1,22,28,7,21,13,43,21,1
Marvin Cuni,FW,Frosinone,it Serie A,22,5.9,8,3,1,3,4,3,4,75.0,1,10,1,9,1,9,0,0
Tomáš Čvančara,FW,Gladbach,de Bundesliga,22,10.0,4,3,0,2,2,1,3,33.3,2,5,1,4,2,6,8,0
Danilo D'Ambrosio,DF,Monza,it Serie A,34,17.1,57,34,34,20,3,28,41,68.3,13,22,13,9,14,71,31,0
Finn Dahmen,GK,Augsburg,de Bundesliga,25,31.0,1,0,1,0,0,1,3,33.3,2,0,0,0,0,1,17,5
Mahmoud Dahoud,MF,Brighton,eng Premier League,27,5.0,9,4,2,4,3,3,9,33.3,6,4,1,3,1,10,5,0
Ameen Al-Dakhil,DF,Burnley,eng Premier League,21,11.7,12,5,4,7,1,1,10,10.0,9,13,6,7,12,24,38,2
Thijs Dallinga,FW,Toulouse,fr Ligue 1,22,27.9,29,15,6,11,12,9,15,60.0,6,11,4,7,3,32,35,0
Diogo Dalot,DF,Manchester Utd,eng Premier League,24,35.3,81,51,58,12,11,51,74,68.9,23,44,16,28,37,118,111,0
Mikkel Damsgaard,MF,Brentford,eng Premier League,23,9.4,29,17,13,9,7,14,40,35.0,26,23,1,22,11,40,10,1
Flavius Daniliuc,DF,Salernitana,it Serie A,22,8.3,19,11,12,5,2,9,19,47.4,10,13,4,9,8,27,15,0
Danilo,MF,Nott'ham Forest,eng Premier League,22,19.9,36,18,22,12,2,21,46,45.7,25,33,8,25,35,71,42,0
Danilo,DF,Juventus,it Serie A,32,27.2,60,36,38,18,4,32,48,66.7,16,34,15,19,37,97,94,0
Arnaut Danjuma,"MF,FW",Everton,eng Premier League,26,6.6,6,4,2,3,1,1,4,25.0,3,4,0,4,3,9,0,0
Kevin Danso,DF,Lens,fr Ligue 1,24,29.5,24,14,12,11,1,15,30,50.0,15,43,30,13,23,47,115,1
Dante,DF,Nice,fr Ligue 1,39,31.6,62,30,44,16,2,38,52,73.1,14,43,22,21,37,99,77,2
Mohammed Daramy,"FW,MF",Reims,fr Ligue 1,21,18.3,10,9,4,4,2,6,16,37.5,10,5,1,4,4,14,4,0
Sergi Darder,MF,Mallorca,es La Liga,29,24.0,39,26,13,21,5,12,31,38.7,19,20,4,16,16,55,16,0
Matteo Darmian,DF,Inter,it Serie A,33,26.7,48,22,23,15,10,20,53,37.7,33,27,11,16,13,61,55,0
Lukas Daschner,"MF,FW",Bochum,de Bundesliga,24,6.0,9,4,2,3,4,4,9,44.4,5,7,0,7,2,11,2,0
David Datro Fofana,FW,Burnley,eng Premier League,20,9.8,10,5,3,5,2,3,6,50.0,3,9,3,6,1,11,2,0
David Datro Fofana,"FW,MF",Union Berlin,de Bundesliga,20,7.6,10,7,3,5,2,4,9,44.4,5,4,0,4,0,10,5,0
Juan David Cabal,DF,Hellas Verona,it Serie A,22,16.6,36,27,19,14,3,18,29,62.1,11,30,9,21,26,62,55,2
Jonathan David,FW,Lille,fr Ligue 1,23,29.2,26,15,6,13,7,8,26,30.8,18,16,0,16,9,35,4,0
Alphonso Davies,DF,Bayern Munich,de Bundesliga,22,22.9,47,24,29,13,5,30,53,56.6,23,30,4,26,26,73,49,1
Ben Davies,DF,Tottenham,eng Premier League,30,12.1,24,17,13,8,3,16,21,76.2,5,17,15,2,10,34,35,0
Paweł Dawidowicz,DF,Hellas Verona,it Serie A,28,23.8,53,30,33,18,2,17,29,58.6,12,17,9,8,24,77,114,1
Craig Dawson,DF,Wolves,eng Premier League,33,24.5,30,20,23,6,1,22,34,64.7,12,51,39,12,16,46,120,1
Kevin De Bruyne,MF,Manchester City,eng Premier League,32,13.6,14,9,1,5,8,7,20,35.0,13,5,0,5,4,18,4,0
Charles De Ketelaere,"FW,MF",Atalanta,it Serie A,22,22.5,33,21,3,12,18,10,20,50.0,10,30,2,28,7,40,6,0
Rodrigo De Paul,MF,Atlético Madrid,es La Liga,29,23.1,31,21,11,14,6,15,38,39.5,23,28,1,27,11,42,15,2
Lorenzo De Silvestri,DF,Bologna,it Serie A,35,7.5,10,8,5,2,3,4,7,57.1,3,9,4,5,6,16,27,0
Thibault De Smet,DF,Reims,fr Ligue 1,25,20.3,56,35,36,16,4,33,59,55.9,26,25,5,20,21,77,51,1
Koni De Winter,DF,Genoa,it Serie A,21,26.4,44,25,26,13,5,21,31,67.7,10,30,10,20,21,65,78,0
Grégoire Defrel,"FW,MF",Sassuolo,it Serie A,32,8.4,17,8,7,5,5,7,15,46.7,8,10,0,10,3,20,9,0
Alessandro Deiola,MF,Cagliari,it Serie A,27,17.9,33,19,13,16,4,18,47,38.3,29,16,6,10,9,42,37,0
Romain Del Castillo,FW,Brest,fr Ligue 1,27,27.7,46,29,14,18,14,18,70,25.7,52,33,1,32,9,55,8,0
Thomas Delaine,"DF,MF",Strasbourg,fr Ligue 1,31,22.7,38,19,29,8,1,20,42,47.6,22,18,2,16,17,55,51,0
Hannes Delcroix,DF,Burnley,eng Premier League,24,6.5,10,6,6,4,0,3,4,75.0,1,9,3,6,9,19,26,0
Olivier Deman,DF,Werder Bremen,de Bundesliga,23,15.2,28,15,21,4,3,18,38,47.4,20,24,8,16,14,42,49,1
Ousmane Dembélé,"MF,FW",Paris S-G,fr Ligue 1,26,16.7,19,14,2,7,10,6,13,46.2,7,11,0,11,5,24,4,1
Jessy Deminguet,"MF,FW",Strasbourg,fr Ligue 1,25,7.7,14,9,6,8,0,6,18,33.3,12,8,0,8,9,23,5,1
Ermedin Demirović,"FW,MF",Augsburg,de Bundesliga,25,31.9,24,14,5,16,3,12,40,30.0,28,28,2,26,11,35,26,0
Sepp van den Berg,DF,Mainz 05,de Bundesliga,21,31.5,38,23,20,15,3,15,26,57.7,11,66,36,30,43,81,159,2
Rémy Descamps,GK,Nantes,fr Ligue 1,27,6.0,0,0,0,0,0,0,0,,0,0,0,0,0,0,7,0
Mikkel Desler,DF,Toulouse,fr Ligue 1,28,17.2,18,12,8,7,3,9,17,52.9,8,32,13,19,19,37,38,0
Arthur Desmas,GK,Le Havre,fr Ligue 1,29,33.0,0,0,0,0,0,0,2,0.0,2,0,0,0,0,0,13,1
Mattia Destro,"FW,MF",Empoli,it Serie A,32,4.1,2,1,0,2,0,1,1,100.0,0,4,0,4,2,4,3,0
Michele Di Gregorio,GK,Monza,it Serie A,26,31.9,1,0,1,0,0,1,4,25.0,3,1,0,1,1,2,10,2
Giovanni Di Lorenzo,DF,Napoli,it Serie A,29,35.9,58,36,26,26,6,32,68,47.1,36,43,16,27,24,82,45,0
Alessandro Di Pardo,"DF,MF",Cagliari,it Serie A,24,4.0,4,1,3,0,1,0,3,0.0,3,9,2,7,5,9,7,0
Boulaye Dia,"FW,MF",Salernitana,it Serie A,26,12.7,4,2,2,2,0,1,3,33.3,2,5,0,5,3,7,7,0
Moussa Diaby,"FW,MF",Aston Villa,eng Premier League,24,24.2,12,5,5,4,3,4,22,18.2,18,8,1,7,9,21,6,0
Mouctar Diakhaby,"DF,MF",Valencia,es La Liga,26,11.9,18,11,9,9,0,11,13,84.6,2,17,7,10,11,29,62,0
Bafodé Diakité,DF,Lille,fr Ligue 1,22,18.8,29,20,12,15,2,24,32,75.0,8,16,8,8,21,50,49,1
Oumar Diakité,FW,Reims,fr Ligue 1,19,17.6,25,12,10,9,6,7,21,33.3,14,13,0,13,7,32,7,0
Amad Diallo,"FW,MF",Manchester Utd,eng Premier League,21,4.3,10,3,1,6,3,3,7,42.9,4,3,1,2,1,11,6,0
Assane Diao,FW,Betis,es La Liga,17,11.6,20,12,5,9,6,6,17,35.3,11,22,4,18,7,27,7,0
Habib Diarra,"MF,FW",Strasbourg,fr Ligue 1,19,25.6,30,23,8,20,2,9,33,27.3,24,23,4,19,17,47,15,0
Moussa Diarra,DF,Toulouse,fr Ligue 1,22,15.5,32,12,16,15,1,13,27,48.1,14,30,14,16,20,52,43,0
Rúben Dias,DF,Manchester City,eng Premier League,26,28.4,39,20,14,21,4,19,26,73.1,7,32,17,15,30,69,77,0
Krépin Diatta,"DF,FW",Monaco,fr Ligue 1,24,13.4,37,20,17,16,4,27,49,55.1,22,17,2,15,16,53,22,0
Mory Diaw,GK,Clermont Foot,fr Ligue 1,30,30.0,1,1,1,0,0,1,2,50.0,1,0,0,0,1,2,13,5
Mahamadou Diawara,MF,Lyon,fr Ligue 1,18,4.0,9,6,4,5,0,3,11,27.3,8,4,1,3,4,13,4,0
Brahim Díaz,"FW,MF",Real Madrid,es La Liga,23,17.2,29,19,4,16,9,6,13,46.2,7,16,1,15,5,34,2,0
Luis Díaz,FW,Liverpool,eng Premier League,26,29.2,35,25,5,17,13,7,30,23.3,23,15,0,15,3,38,8,0
Bamba Dieng,FW,Lorient,fr Ligue 1,23,6.1,3,3,0,3,0,1,3,33.3,2,3,0,3,0,3,7,0
Eric Dier,DF,Bayern Munich,de Bundesliga,29,13.0,11,8,5,5,1,5,6,83.3,1,20,12,8,10,21,48,1
Lucas Digne,DF,Aston Villa,eng Premier League,30,26.8,47,19,35,9,3,25,44,56.8,19,20,2,18,26,73,67,0
Federico Dimarco,DF,Inter,it Serie A,25,23.1,42,25,19,14,9,17,35,48.6,18,18,3,15,9,51,34,1
Stole Dimitrievski,GK,Rayo Vallecano,es La Liga,29,37.0,1,1,1,0,0,1,1,100.0,0,0,0,0,0,1,17,3
Junior Dina Ebimbe,"MF,DF",Eint Frankfurt,de Bundesliga,22,21.7,44,29,15,17,12,18,41,43.9,23,28,7,21,9,53,39,1
Eren Dinkçi,"FW,MF",Heidenheim,de Bundesliga,21,29.4,32,18,16,13,3,19,48,39.6,29,40,4,36,12,44,21,0
Sinaly Diomande,DF,Lyon,fr Ligue 1,22,9.9,10,4,5,3,2,9,16,56.3,7,12,9,3,15,25,26,1
Issa Diop,DF,Fulham,eng Premier League,26,15.8,30,16,23,5,2,15,20,75.0,5,28,19,9,17,47,80,1
Sofiane Diop,FW,Nice,fr Ligue 1,23,5.5,8,6,3,4,1,4,10,40.0,6,4,0,4,3,11,3,0
Andy Diouf,MF,Lens,fr Ligue 1,20,14.6,28,19,12,11,5,14,22,63.6,8,13,3,10,3,31,5,1
Yehvann Diouf,GK,Reims,fr Ligue 1,23,34.0,0,0,0,0,0,0,1,0.0,1,0,0,0,1,1,19,3
Axel Disasi,DF,Chelsea,eng Premier League,25,28.7,33,19,20,10,3,23,30,76.7,7,26,19,7,18,51,102,2
Djené,"DF,MF",Getafe,es La Liga,31,27.6,34,19,18,13,3,15,26,57.7,11,31,15,16,23,57,70,0
Koffi Djidji,DF,Torino,it Serie A,30,8.4,14,9,9,5,0,3,4,75.0,1,10,5,5,10,24,20,0
Berat Djimsiti,DF,Atalanta,it Serie A,30,31.5,42,24,29,12,1,19,31,61.3,12,53,33,20,57,99,100,0
Marko Dmitrović,GK,Sevilla,es La Liga,31,13.0,1,1,1,0,0,1,2,50.0,1,0,0,0,1,2,5,0
Ritsu Doan,"DF,MF",Freiburg,de Bundesliga,25,25.0,50,27,21,19,10,21,36,58.3,15,30,3,27,9,59,29,0
Dodô,DF,Fiorentina,it Serie A,24,5.8,5,3,1,4,0,2,5,40.0,3,2,0,2,5,10,11,0
Danilho Doekhi,DF,Union Berlin,de Bundesliga,25,24.0,34,23,18,16,0,15,21,71.4,6,46,25,21,38,72,111,1
Matt Doherty,"DF,MF",Wolves,eng Premier League,31,12.8,31,18,17,10,4,12,23,52.2,11,15,5,10,7,38,47,0
Josh Doig,DF,Hellas Verona,it Serie A,21,9.2,16,9,9,7,0,13,17,76.5,4,12,3,9,4,20,17,1
Josh Doig,DF,Sassuolo,it Serie A,21,14.9,25,17,16,9,0,15,27,55.6,12,31,10,21,16,41,38,0
Jeremy Doku,"FW,MF",Manchester City,eng Premier League,21,17.7,39,22,13,12,14,9,20,45.0,11,14,0,14,9,48,5,0
Carlos Dominguez,DF,Celta Vigo,es La Liga,22,17.6,33,21,17,9,7,23,37,62.2,14,24,12,12,22,55,78,0
Nicolás Domínguez,"MF,FW",Nott'ham Forest,eng Premier League,25,16.6,63,34,35,27,1,23,48,47.9,25,31,5,26,18,81,24,0
Gianluigi Donnarumma,GK,Paris S-G,fr Ligue 1,24,24.1,0,0,0,0,0,0,0,,0,0,0,0,1,1,9,4
Patrick Dorgu,"DF,MF",Lecce,it Serie A,18,17.4,43,22,22,17,4,22,34,64.7,12,16,5,11,9,52,45,2
Niklas Dorsch,MF,Augsburg,de Bundesliga,25,15.4,35,24,13,21,1,13,33,39.4,20,15,9,6,16,51,27,0
Alberto Dossena,DF,Cagliari,it Serie A,24,33.1,55,35,43,12,0,32,48,66.7,16,50,27,23,45,100,172,2
Carlos Dotor,MF,Celta Vigo,es La Liga,22,7.9,14,7,3,8,3,4,13,30.8,9,12,2,10,4,18,4,0
Abdoulaye Doucouré,"FW,MF",Everton,eng Premier League,30,29.2,43,27,20,14,9,18,46,39.1,28,23,3,20,15,58,19,0
Cheick Doucouré,MF,Crystal Palace,eng Premier League,23,10.2,34,17,15,13,6,18,30,60.0,12,13,2,11,20,54,12,0
Siriné Doucouré,FW,Lorient,fr Ligue 1,21,4.7,8,6,0,4,4,3,3,100.0,0,4,0,4,1,9,6,0
Désiré Doué,"MF,FW",Rennes,fr Ligue 1,18,18.1,32,18,11,14,7,10,33,30.3,23,30,1,29,14,46,8,0
Guela Doué,DF,Rennes,fr Ligue 1,20,13.7,28,21,14,12,2,22,32,68.8,10,12,1,11,15,43,65,1
Alfie Doughty,DF,Luton Town,eng Premier League,23,32.5,63,40,29,18,16,37,82,45.1,45,51,9,42,31,94,43,4
Douglas,MF,Nantes,fr Ligue 1,26,19.7,70,42,34,30,6,30,59,50.8,29,22,8,14,26,96,30,0
Ismaël Doukouré,"MF,DF",Strasbourg,fr Ligue 1,20,18.4,23,16,7,14,2,13,21,61.9,8,19,7,12,19,42,29,2
Kamory Doumbia,MF,Brest,fr Ligue 1,20,9.8,28,18,8,10,10,10,29,34.5,19,14,0,14,9,37,6,0
Anastasios Douvikas,FW,Celta Vigo,es La Liga,23,10.1,15,7,2,6,7,3,8,37.5,5,6,3,3,2,17,9,0
Artem Dovbyk,FW,Girona,es La Liga,26,28.7,4,3,2,1,1,0,2,0.0,2,8,1,7,0,4,17,0
Nikola Dovedan,"MF,FW",Heidenheim,de Bundesliga,29,7.3,14,9,2,10,2,5,25,20.0,20,9,0,9,1,15,3,0
Tommy Doyle,MF,Wolves,eng Premier League,21,13.6,26,13,11,10,5,14,23,60.9,9,22,9,13,12,38,18,0
Radu Drăgușin,DF,Tottenham,eng Premier League,21,4.8,5,3,5,0,0,3,3,100.0,0,5,4,1,8,13,19,0
Radu Drăgușin,DF,Genoa,it Serie A,21,19.0,16,11,9,6,1,8,9,88.9,1,18,12,6,21,37,87,3
Dion Drena Beljo,"FW,MF",Augsburg,de Bundesliga,21,6.5,0,0,0,0,0,0,2,0.0,2,8,1,7,1,1,4,0
Tim Drexler,DF,Hoffenheim,de Bundesliga,18,6.4,16,9,12,4,0,8,17,47.1,9,12,8,4,8,24,14,0
Domingos Duarte,DF,Getafe,es La Liga,28,10.1,7,4,6,0,1,5,7,71.4,2,7,5,2,8,15,27,0
Rubén Duarte,DF,Alavés,es La Liga,27,20.9,39,20,21,16,2,21,31,67.7,10,21,6,15,23,62,69,0
Martin Dúbravka,GK,Newcastle Utd,eng Premier League,34,22.1,0,0,0,0,0,0,4,0.0,4,0,0,0,0,0,8,1
Marvin Ducksch,FW,Werder Bremen,de Bundesliga,29,30.0,8,3,4,3,1,6,14,42.9,8,2,0,2,4,12,25,0
Ondrej Duda,MF,Hellas Verona,it Serie A,28,27.3,59,39,17,35,7,31,52,59.6,21,29,12,17,26,85,21,0
Denzel Dumfries,DF,Inter,it Serie A,27,18.2,22,13,9,11,2,9,23,39.1,14,15,6,9,12,34,33,1
Alfred Duncan,MF,Fiorentina,it Serie A,30,21.0,35,22,13,15,7,15,35,42.9,20,27,5,22,11,46,13,0
Lewis Dunk,DF,Brighton,eng Premier League,31,31.9,27,14,17,9,1,13,36,36.1,23,49,37,12,31,58,90,1
Jhon Durán,"FW,MF",Aston Villa,eng Premier League,19,5.3,6,5,3,1,2,1,6,16.7,5,6,0,6,1,7,10,0
Hugo Duro,FW,Valencia,es La Liga,23,33.1,16,8,5,8,3,9,29,31.0,20,24,5,19,5,21,27,0
Jean-Kevin Duverne,DF,Nantes,fr Ligue 1,26,15.0,37,19,16,17,4,18,44,40.9,26,17,5,12,18,55,34,0
Paulo Dybala,"FW,MF",Roma,it Serie A,29,21.8,22,13,3,10,9,2,18,11.1,16,12,0,12,3,25,6,1
Aron Dønnum,"FW,MF",Toulouse,fr Ligue 1,25,17.7,16,10,3,8,5,7,22,31.8,15,13,0,13,8,24,16,1
Festy Ebosele,DF,Udinese,it Serie A,20,18.9,33,20,23,9,1,21,35,60.0,14,33,2,31,10,43,27,0
Tyronne Ebuehi,DF,Empoli,it Serie A,27,12.2,14,9,9,5,0,7,11,63.6,4,9,4,5,6,20,27,1
Ederson,GK,Manchester City,eng Premier League,29,30.9,0,0,0,0,0,0,1,0.0,1,0,0,0,0,0,10,1
Éderson,MF,Atalanta,it Serie A,24,31.9,83,49,38,38,7,44,63,69.8,19,48,8,40,41,124,33,1
Odsonne Édouard,"FW,MF",Crystal Palace,eng Premier League,25,17.3,24,12,8,8,8,4,19,21.1,15,17,1,16,6,30,19,0
John Egan,DF,Sheffield Utd,eng Premier League,30,5.4,6,4,4,2,0,4,11,36.4,7,10,4,6,13,19,39,1
Maximilian Eggestein,MF,Freiburg,de Bundesliga,26,32.4,49,24,25,19,5,15,36,41.7,21,53,19,34,28,77,40,1
Kingsley Ehizibue,DF,Udinese,it Serie A,28,10.6,22,14,16,4,2,11,18,61.1,7,21,3,18,8,30,36,0
Hjalmar Ekdal,DF,Burnley,eng Premier League,24,4.9,4,2,2,2,0,2,4,50.0,2,10,5,5,6,10,21,0
Hugo Ekitike,FW,Eint Frankfurt,de Bundesliga,21,8.0,11,7,3,6,2,4,6,66.7,2,10,0,10,2,13,4,0
Caleb Ekuban,FW,Genoa,it Serie A,29,12.6,8,4,2,4,2,5,9,55.6,4,11,3,8,1,9,7,0
Anthony Elanga,"FW,MF",Nott'ham Forest,eng Premier League,21,27.0,33,19,20,6,7,17,36,47.2,19,22,2,20,8,41,20,1
Simon Elisor,FW,Metz,fr Ligue 1,24,8.5,9,2,3,2,4,2,6,33.3,4,6,1,5,0,9,9,0
Harvey Elliott,"MF,FW",Liverpool,eng Premier League,20,15.0,27,17,8,14,5,10,31,32.3,21,27,0,27,6,33,7,0
Aritz Elustondo,DF,Real Sociedad,es La Liga,29,9.0,11,7,5,4,2,6,14,42.9,8,12,10,2,7,18,26,0
Nico Elvedi,DF,Gladbach,de Bundesliga,26,27.6,33,18,22,10,1,18,24,75.0,6,40,25,15,43,76,150,2
Adri Embarba,"FW,MF",Almería,es La Liga,31,27.5,55,37,29,15,11,26,53,49.1,27,37,1,36,15,70,12,0
Emanuel Emegha,FW,Strasbourg,fr Ligue 1,20,23.1,8,5,2,4,2,4,9,44.4,5,13,3,10,2,10,25,0
Emerson,DF,Tottenham,eng Premier League,24,12.9,36,24,23,10,3,21,43,48.8,22,23,10,13,20,56,50,1
Youssef En-Nesyri,FW,Sevilla,es La Liga,26,28.6,10,7,3,4,3,0,10,0.0,10,9,1,8,7,17,29,1
Julio Enciso,"MF,FW",Brighton,eng Premier League,19,5.3,6,2,3,2,1,2,7,28.6,5,11,0,11,0,6,3,0
Wataru Endo,MF,Liverpool,eng Premier League,30,19.1,48,28,11,31,6,20,61,32.8,41,24,2,22,20,68,31,3
Arne Engels,"MF,DF",Augsburg,de Bundesliga,19,15.6,33,18,15,14,4,12,29,41.4,17,23,1,22,15,48,21,0
Christian Eriksen,MF,Manchester Utd,eng Premier League,31,12.7,18,13,5,10,3,12,33,36.4,21,17,6,11,4,22,13,0
Martin Erlic,DF,Sassuolo,it Serie A,25,29.1,37,22,26,8,3,20,30,66.7,10,31,16,15,28,65,128,1
Gonzalo Escalante,MF,Cádiz,es La Liga,30,18.9,39,24,16,14,9,20,55,36.4,35,23,5,18,26,65,33,2
Alfonso Espino,DF,Rayo Vallecano,es La Liga,31,27.9,67,45,43,22,2,30,82,36.6,52,26,4,22,40,107,63,0
Maxime Estève,DF,Burnley,eng Premier League,21,14.5,27,10,15,12,0,18,32,56.3,14,21,10,11,27,54,56,0
Maxime Estève,DF,Montpellier,fr Ligue 1,21,11.1,16,12,11,5,0,10,15,66.7,5,13,9,4,18,34,50,0
Pervis Estupiñán,DF,Brighton,eng Premier League,25,13.8,26,13,12,11,3,14,30,46.7,16,14,4,10,21,47,20,0
Jonny Evans,DF,Manchester Utd,eng Premier League,35,15.5,22,14,20,2,0,12,21,57.1,9,25,18,7,23,45,76,0
Eberechi Eze,"MF,FW",Crystal Palace,eng Premier League,25,22.8,35,17,4,18,13,15,31,48.4,16,27,2,25,11,46,6,0
Abde Ezzalzouli,FW,Betis,es La Liga,21,9.6,17,14,7,5,5,4,14,28.6,10,10,0,10,5,22,5,0
Giovanni Fabbian,"MF,FW",Bologna,it Serie A,20,11.7,17,10,9,7,1,7,12,58.3,5,5,2,3,7,24,11,0
Łukasz Fabiański,GK,West Ham,eng Premier League,38,8.0,1,0,1,0,0,1,2,50.0,1,0,0,0,1,2,4,0
Nicolò Fagioli,MF,Juventus,it Serie A,22,4.9,5,3,1,3,1,3,7,42.9,4,3,0,3,4,9,1,0
Romain Faivre,"MF,FW",Lorient,fr Ligue 1,25,16.1,13,6,5,4,4,6,15,40.0,9,6,1,5,7,20,3,1
Radamel Falcao,"FW,DF",Rayo Vallecano,es La Liga,37,4.5,7,5,1,5,1,1,3,33.3,2,2,0,2,3,10,4,0
Wladimiro Falcone,GK,Lecce,it Serie A,28,38.0,0,0,0,0,0,0,0,,0,1,0,1,1,1,21,2
Fali,DF,Cádiz,es La Liga,29,28.3,41,26,29,11,1,21,36,58.3,15,38,24,14,27,68,120,0
Davide Faraoni,DF,Hellas Verona,it Serie A,31,6.7,13,10,5,6,2,7,10,70.0,3,9,5,4,6,19,21,0
Davide Faraoni,DF,Fiorentina,it Serie A,31,4.4,9,4,5,2,2,5,11,45.5,6,3,1,2,5,14,14,0
Ansu Fati,"MF,FW",Brighton,eng Premier League,20,5.8,5,3,1,2,2,1,11,9.1,10,8,0,8,3,8,3,0
Khalil Fayad,"FW,MF",Montpellier,fr Ligue 1,19,11.4,28,15,17,7,4,9,22,40.9,13,15,3,12,14,42,6,0
Federico Fazio,DF,Salernitana,it Serie A,36,15.1,18,11,14,4,0,8,14,57.1,6,22,19,3,17,35,99,1
Jacopo Fazzini,MF,Empoli,it Serie A,20,13.7,49,25,27,13,9,30,53,56.6,23,21,3,18,12,61,18,0
Peter Federico,"MF,FW",Valencia,es La Liga,21,7.2,5,3,3,1,1,1,10,10.0,9,11,0,11,7,12,10,0
Nabil Fekir,"MF,FW",Betis,es La Liga,30,11.7,15,10,5,7,3,5,10,50.0,5,9,0,9,7,22,3,0
Felipe,DF,Nott'ham Forest,eng Premier League,34,4.2,12,9,9,3,0,9,12,75.0,3,4,1,3,4,16,12,0
Luiz Felipe,DF,Betis,es La Liga,26,4.0,7,3,5,2,0,4,5,80.0,1,10,4,6,4,11,16,0
João Félix,FW,Barcelona,es La Liga,23,17.1,22,16,9,7,6,8,22,36.4,14,14,1,13,10,32,11,0
Ohis Felix Uduokhai,DF,Augsburg,de Bundesliga,25,32.5,37,21,18,14,5,16,25,64.0,9,45,35,10,46,83,178,2
Kiko Femenía,DF,Villarreal,es La Liga,32,17.6,35,25,19,13,3,19,34,55.9,15,21,6,15,31,66,45,0
Evan Ferguson,FW,Brighton,eng Premier League,18,15.2,14,6,4,7,3,5,14,35.7,9,10,3,7,2,16,8,0
Lewis Ferguson,MF,Bologna,it Serie A,23,30.1,37,21,16,17,4,16,37,43.2,21,25,8,17,17,54,27,1
Bruno Fernandes,"MF,FW",Manchester Utd,eng Premier League,28,34.6,68,38,27,25,16,30,88,34.1,58,49,6,43,27,95,50,2
Edimilson Fernandes,DF,Mainz 05,de Bundesliga,27,14.3,25,16,15,9,1,16,24,66.7,8,14,6,8,22,47,52,0
Aitor Fernández,GK,Osasuna,es La Liga,32,6.1,0,0,0,0,0,0,1,0.0,1,0,0,0,0,0,5,1
Álex Fernández,MF,Cádiz,es La Liga,30,14.3,19,9,10,9,0,11,22,50.0,11,17,5,12,15,34,30,0
Carlos Fernández,FW,Real Sociedad,es La Liga,27,4.5,11,7,3,6,2,0,2,0.0,2,4,0,4,0,11,5,0
Enzo Fernández,MF,Chelsea,eng Premier League,22,24.5,50,22,22,18,10,27,65,41.5,38,36,13,23,17,67,28,0
Valery Fernández,"MF,FW",Girona,es La Liga,23,5.6,11,9,4,7,0,6,8,75.0,2,6,1,5,1,12,4,0
Fernando,GK,Almería,es La Liga,33,4.0,0,0,0,0,0,0,0,,0,1,0,1,0,0,2,0
Fernando,MF,Sevilla,es La Liga,36,5.1,9,8,2,4,3,5,9,55.6,4,2,0,2,7,16,9,0
André Ferreira,GK,Granada,es La Liga,27,14.9,0,0,0,0,0,0,1,0.0,1,0,0,0,0,0,9,2
João Ferreira,DF,Udinese,it Serie A,22,20.2,58,42,36,18,4,34,58,58.6,24,27,6,21,29,87,89,0
Jordan Ferri,MF,Montpellier,fr Ligue 1,31,22.6,36,22,16,17,3,20,67,29.9,47,19,1,18,13,49,23,0
Max Finkgräfe,"DF,FW",Köln,de Bundesliga,19,19.5,65,39,40,25,0,39,74,52.7,35,35,10,25,22,87,39,0
Vincenzo Fiorillo,GK,Salernitana,it Serie A,33,4.0,0,0,0,0,0,0,0,,0,0,0,0,0,0,0,1
Mark Flekken,GK,Brentford,eng Premier League,30,36.5,1,1,1,0,0,1,5,20.0,4,1,0,1,0,1,17,1
Alessandro Florenzi,DF,Milan,it Serie A,32,19.2,43,21,26,12,5,26,48,54.2,22,16,9,7,20,63,25,1
Phil Foden,"FW,MF",Manchester City,eng Premier League,23,31.7,31,20,11,10,10,13,31,41.9,18,30,0,30,13,44,18,1
Wes Foderingham,GK,Sheffield Utd,eng Premier League,32,29.4,5,3,5,0,0,5,6,83.3,1,0,0,0,0,5,18,6
Malick Fofana,FW,Lyon,fr Ligue 1,18,6.2,5,4,3,1,1,4,9,44.4,5,3,0,3,5,10,9,0
Youssouf Fofana,MF,Monaco,fr Ligue 1,24,30.0,61,39,19,36,6,30,66,45.5,36,35,7,28,37,98,31,1
Jonas Föhrenbach,DF,Heidenheim,de Bundesliga,27,31.0,44,24,24,14,6,19,36,52.8,17,34,19,15,31,75,70,0
Thomas Foket,DF,Reims,fr Ligue 1,28,20.4,32,17,21,8,3,20,45,44.4,25,34,12,22,25,57,36,0
Michael Folorunsho,"MF,FW",Hellas Verona,it Serie A,25,30.9,50,28,21,22,7,23,57,40.4,34,45,12,33,17,67,44,2
Pablo Fornals,"MF,FW",West Ham,eng Premier League,27,4.7,10,6,4,3,3,5,16,31.3,11,8,1,7,6,16,7,0
Pablo Fornals,"FW,MF",Betis,es La Liga,27,12.8,24,16,8,11,5,12,22,54.5,10,14,0,14,22,46,10,2
Emil Forsberg,"MF,FW",RB Leipzig,de Bundesliga,31,5.2,7,3,2,5,0,5,12,41.7,7,7,0,7,0,7,5,0
Philipp Förster,"MF,FW",Bochum,de Bundesliga,28,4.3,9,5,3,4,2,2,6,33.3,4,3,0,3,7,16,3,0
Lyle Foster,"FW,MF",Burnley,eng Premier League,22,21.1,19,10,5,6,8,6,17,35.3,11,13,3,10,3,22,34,0
Dimitri Foulquier,"DF,MF",Valencia,es La Liga,30,20.5,39,22,22,13,4,18,26,69.2,8,10,1,9,16,55,49,1
Juan Foyth,DF,Villarreal,es La Liga,25,11.8,26,15,18,8,0,12,27,44.4,15,17,4,13,12,38,44,0
Bartol Franjić,MF,Darmstadt 98,de Bundesliga,23,13.7,15,12,4,10,1,7,28,25.0,21,12,4,8,30,45,29,2
Przemysław Frankowski,DF,Lens,fr Ligue 1,28,24.4,60,39,25,26,9,31,74,41.9,43,30,7,23,25,85,36,0
Davide Frattesi,MF,Inter,it Serie A,23,10.6,10,6,3,7,0,4,8,50.0,4,9,3,6,5,15,19,0
Morten Frendrup,MF,Genoa,it Serie A,22,34.9,133,72,47,70,16,55,91,60.4,36,55,14,41,51,184,42,1
Remo Freuler,MF,Bologna,it Serie A,31,29.2,78,50,41,32,5,38,69,55.1,31,37,9,28,36,114,53,2
Marco Friedl,DF,Werder Bremen,de Bundesliga,25,24.4,53,32,38,15,0,36,48,75.0,12,45,29,16,35,88,129,0
Marvin Friedrich,DF,Gladbach,de Bundesliga,27,17.4,23,15,16,6,1,12,20,60.0,8,28,20,8,17,40,87,0
Jeremie Frimpong,DF,Leverkusen,de Bundesliga,22,25.0,26,17,12,7,7,8,20,40.0,12,26,0,26,7,33,17,0
Jorge de Frutos,"FW,MF",Rayo Vallecano,es La Liga,26,17.2,19,8,5,8,6,7,22,31.8,15,12,0,12,7,26,18,0
Chris Führich,"FW,MF",Stuttgart,de Bundesliga,25,28.5,30,19,6,14,10,16,37,43.2,21,31,0,31,7,37,7,0
Angelo Fulgini,MF,Lens,fr Ligue 1,26,15.3,23,14,6,13,4,11,19,57.9,8,22,1,21,8,31,11,0
Niclas Füllkrug,FW,Dortmund,de Bundesliga,30,24.6,7,2,1,6,0,2,8,25.0,6,17,4,13,2,9,25,0
Matteo Gabbia,DF,Milan,it Serie A,23,14.2,29,20,15,13,1,18,24,75.0,6,11,6,5,10,39,48,0
Matteo Gabbia,DF,Villarreal,es La Liga,23,5.3,10,6,4,6,0,5,8,62.5,3,5,2,3,8,18,36,1
Gianluca Gaetano,"FW,MF",Cagliari,it Serie A,23,8.3,7,4,0,4,3,2,7,28.6,5,4,0,4,3,10,4,0
Roberto Gagliardini,"MF,DF",Monza,it Serie A,29,26.2,61,30,27,25,9,31,50,62.0,19,30,11,19,31,92,38,0
Cody Gakpo,"FW,MF",Liverpool,eng Premier League,24,18.3,27,17,8,14,5,8,25,32.0,17,21,4,17,14,41,7,0
Javi Galán,DF,Real Sociedad,es La Liga,28,11.9,38,22,15,19,4,15,30,50.0,15,24,1,23,14,52,17,1
Iñigo Ruiz de Galarreta,MF,Athletic Club,es La Liga,29,23.2,49,31,15,26,8,24,49,49.0,25,18,5,13,12,61,17,0
Conor Gallagher,MF,Chelsea,eng Premier League,23,34.8,85,52,37,31,17,33,77,42.9,44,50,11,39,43,128,34,0
Antonino Gallo,DF,Lecce,it Serie A,23,27.7,43,27,31,11,1,31,49,63.3,18,34,9,25,25,68,67,0
Cristian Gamboa,DF,Bochum,de Bundesliga,33,13.2,24,18,12,11,1,14,33,42.4,19,20,7,13,15,39,34,1
Kévin Gameiro,"FW,MF",Strasbourg,fr Ligue 1,36,15.0,10,10,5,3,2,2,17,11.8,15,9,0,9,3,13,7,0
Idrissa Gana Gueye,MF,Everton,eng Premier League,33,20.9,73,44,32,27,14,29,46,63.0,17,24,7,17,28,101,16,0
Aleix García,MF,Girona,es La Liga,26,35.5,49,28,17,26,6,28,54,51.9,26,45,17,28,36,85,53,3
Álvaro García,"FW,MF",Rayo Vallecano,es La Liga,30,27.5,34,25,15,10,9,7,34,20.6,27,35,0,35,36,70,33,0
Dani García,MF,Athletic Club,es La Liga,33,8.3,17,11,4,7,6,12,24,50.0,12,9,3,6,8,25,11,0
David García,DF,Osasuna,es La Liga,29,25.9,29,18,19,9,1,16,26,61.5,10,40,19,21,18,47,115,2
Eric García,DF,Girona,es La Liga,22,29.3,55,37,34,18,3,34,49,69.4,15,36,18,18,30,85,79,2
Fran Garcia,DF,Real Madrid,es La Liga,23,15.5,25,17,11,12,2,13,31,41.9,18,16,3,13,19,44,28,1
Francisco Jesús Crespo García,FW,Las Palmas,es La Liga,27,5.6,12,8,3,6,3,6,18,33.3,12,4,0,4,2,14,5,0
Raúl García,"FW,MF",Athletic Club,es La Liga,37,4.7,9,6,2,4,3,4,9,44.4,5,10,1,9,3,12,9,0
Rubén García,"FW,MF",Osasuna,es La Liga,30,17.2,32,18,8,17,7,13,33,39.4,20,23,3,20,12,44,23,0
Ulisses Garcia,DF,Marseille,fr Ligue 1,27,10.1,21,16,6,13,2,13,20,65.0,7,8,3,5,7,28,13,2
Unai García,DF,Osasuna,es La Liga,31,6.2,12,9,9,2,1,5,10,50.0,5,7,1,6,8,20,18,0
Alejandro Garnacho,FW,Manchester Utd,eng Premier League,19,28.5,22,15,7,6,9,12,45,26.7,33,26,2,24,18,40,18,0
James Garner,MF,Everton,eng Premier League,22,33.4,83,44,32,38,13,35,82,42.7,47,45,14,31,45,128,47,1
Luca Garritano,"MF,DF",Frosinone,it Serie A,29,5.4,10,5,7,2,1,5,15,33.3,10,13,0,13,4,14,8,1
Johan Gastien,MF,Clermont Foot,fr Ligue 1,35,25.1,43,22,18,21,4,23,81,28.4,58,31,9,22,36,79,24,4
Federico Gatti,DF,Juventus,it Serie A,25,29.3,33,19,16,16,1,19,24,79.2,5,26,15,11,19,52,90,1
Gavi,"MF,FW",Barcelona,es La Liga,18,10.5,39,21,20,14,5,18,36,50.0,18,19,3,16,8,47,16,1
Paulo Gazzaniga,GK,Girona,es La Liga,31,38.0,2,2,2,0,0,2,4,50.0,2,0,0,0,0,2,12,1
Yann Gboho,"MF,FW",Toulouse,fr Ligue 1,22,13.3,14,4,6,6,2,8,23,34.8,15,21,1,20,4,18,2,0
Gelabert,"MF,FW",Toulouse,fr Ligue 1,22,8.4,14,8,5,6,3,7,20,35.0,13,8,2,6,5,19,8,0
Francesco Gelli,"MF,DF",Frosinone,it Serie A,26,17.3,19,13,8,4,7,10,24,41.7,14,19,3,16,11,30,27,1
Valentin Gendrey,DF,Lecce,it Serie A,23,33.8,55,33,35,16,4,30,46,65.2,16,40,11,29,35,90,99,0
Denis Genreau,"MF,FW",Toulouse,fr Ligue 1,24,5.2,12,9,6,6,0,8,15,53.3,7,8,1,7,6,18,8,0
Yannick Gerhardt,"MF,DF",Wolfsburg,de Bundesliga,29,18.1,31,20,16,12,3,9,32,28.1,23,15,2,13,7,38,35,0
Saman Ghoddos,DF,Brentford,eng Premier League,29,8.2,28,19,19,7,2,17,31,54.8,14,9,2,7,5,33,12,0
Lautaro Gianetti,DF,Udinese,it Serie A,29,7.0,9,4,7,2,0,4,5,80.0,1,10,6,4,19,28,39,0
Morgan Gibbs-White,"MF,FW",Nott'ham Forest,eng Premier League,23,35.1,36,24,6,20,10,14,33,42.4,19,31,8,23,17,53,21,0
Samuel Gigot,DF,Marseille,fr Ligue 1,29,19.2,33,22,16,13,4,13,19,68.4,6,28,18,10,25,58,93,1
David Gil,GK,Cádiz,es La Liga,29,4.1,0,0,0,0,0,0,1,0.0,1,0,0,0,0,0,3,0
Mario Gila,DF,Lazio,it Serie A,22,20.1,32,14,23,8,1,19,34,55.9,15,27,14,13,20,52,69,0
Billy Gilmour,MF,Brighton,eng Premier League,22,23.6,26,16,14,10,2,11,35,31.4,24,23,9,14,11,37,14,1
Benedikt Gimber,DF,Heidenheim,de Bundesliga,26,22.5,40,24,25,14,1,19,35,54.3,16,27,17,10,16,56,101,1
Gvidas Gineitis,MF,Torino,it Serie A,19,6.0,11,7,3,8,0,4,7,57.1,3,10,4,6,4,15,9,1
Matthias Ginter,DF,Freiburg,de Bundesliga,29,21.3,29,15,19,9,1,16,29,55.2,13,40,26,14,16,45,93,0
Olivier Giroud,FW,Milan,it Serie A,36,26.3,17,11,6,6,5,2,14,14.3,12,14,3,11,6,23,22,0
Jamie Gittens,"FW,MF",Dortmund,de Bundesliga,18,11.8,14,7,6,7,1,2,17,11.8,15,11,2,9,4,18,7,0
Klaus Gjasula,"DF,MF",Darmstadt 98,de Bundesliga,33,15.1,44,22,18,25,1,17,30,56.7,13,26,14,12,19,63,42,2
Serge Gnabry,"FW,MF",Bayern Munich,de Bundesliga,28,4.8,8,5,0,5,3,2,13,15.4,11,5,0,5,3,11,2,0
Ben Godfrey,DF,Everton,eng Premier League,25,12.4,30,20,17,8,5,15,28,53.6,13,14,8,6,16,46,57,0
Edoardo Goldaniga,DF,Cagliari,it Serie A,29,11.2,12,7,9,3,0,4,10,40.0,6,11,7,4,15,27,37,1
Pierluigi Gollini,GK,Napoli,it Serie A,28,7.0,1,1,1,0,0,1,1,100.0,0,0,0,0,1,2,2,0
Aleksandr Golovin,"MF,FW",Monaco,fr Ligue 1,27,23.9,42,30,14,22,6,15,42,35.7,27,37,3,34,21,63,14,0
André Gomes,"MF,FW",Everton,eng Premier League,30,5.6,7,4,2,3,2,3,13,23.1,10,10,1,9,3,10,4,1
Angel Gomes,MF,Lille,fr Ligue 1,22,28.6,26,13,4,15,7,14,32,43.8,18,23,6,17,18,44,28,1
João Gomes,MF,Wolves,eng Premier League,22,29.4,128,74,67,49,12,44,99,44.4,55,51,8,43,18,146,29,2
Toti Gomes,DF,Wolves,eng Premier League,24,30.8,44,25,32,8,4,24,37,64.9,13,40,19,21,26,70,93,2
Joe Gomez,DF,Liverpool,eng Premier League,26,19.8,47,31,24,16,7,30,63,47.6,33,26,4,22,19,66,50,2
Maxi Gómez,FW,Cádiz,es La Liga,26,12.9,6,4,2,3,1,3,5,60.0,2,8,3,5,3,9,3,0
Moi Gómez,"MF,FW",Osasuna,es La Liga,29,22.3,30,19,7,19,4,9,24,37.5,15,15,1,14,11,41,22,0
Unai Gómez,MF,Athletic Club,es La Liga,20,9.7,12,10,2,6,4,5,10,50.0,5,13,2,11,2,14,9,0
Maxime Gonalons,MF,Clermont Foot,fr Ligue 1,34,14.4,47,33,14,27,6,25,57,43.9,32,18,3,15,20,67,11,0
Édgar González,"DF,MF",Almería,es La Liga,26,28.0,45,21,22,20,3,25,49,51.0,24,48,28,20,38,83,130,3
Giovanni González,DF,Mallorca,es La Liga,28,27.4,73,45,37,32,4,40,81,49.4,41,24,3,21,31,104,60,2
Joan Gonzàlez,MF,Lecce,it Serie A,21,14.3,31,18,16,12,3,17,28,60.7,11,20,3,17,5,36,9,0
Nicolás González,FW,Fiorentina,it Serie A,25,21.3,28,18,15,8,5,8,28,28.6,20,26,1,25,12,40,9,0
Anthony Gordon,FW,Newcastle Utd,eng Premier League,22,32.1,55,34,16,28,11,22,64,34.4,42,27,0,27,7,62,7,0
Leon Goretzka,MF,Bayern Munich,de Bundesliga,28,24.9,41,23,18,14,9,24,54,44.4,30,44,8,36,31,72,42,1
Andoni Gorosabel,DF,Alavés,es La Liga,26,31.7,62,42,40,17,5,38,75,50.7,37,24,8,16,28,90,69,0
Robin Gosens,"DF,MF",Union Berlin,de Bundesliga,29,25.4,63,44,25,31,7,30,44,68.2,14,52,9,43,36,99,75,0
Mario Götze,MF,Eint Frankfurt,de Bundesliga,31,23.0,51,34,18,25,8,28,62,45.2,34,19,3,16,14,65,10,0
Amine Gouiri,"FW,MF",Rennes,fr Ligue 1,23,23.0,20,10,4,11,5,8,19,42.1,11,18,1,17,14,34,12,0
Jeffrey Gouweleeuw,DF,Augsburg,de Bundesliga,32,28.8,35,23,13,17,5,16,25,64.0,9,44,24,20,35,70,108,0
Jonathan Gradit,DF,Lens,fr Ligue 1,30,23.5,32,20,15,14,3,19,35,54.3,16,30,17,13,37,69,61,0
Samuel Grandsir,"MF,FW",Le Havre,fr Ligue 1,26,6.7,16,12,5,9,2,8,18,44.4,10,4,0,4,3,19,3,1
Alberto Grassi,MF,Empoli,it Serie A,28,20.1,30,18,13,13,4,10,26,38.5,16,26,11,15,41,71,37,0
Ryan Gravenberch,MF,Liverpool,eng Premier League,21,12.5,26,12,5,13,8,12,29,41.4,17,20,2,18,14,40,11,0
Ivo Grbić,GK,Sheffield Utd,eng Premier League,27,8.6,0,0,0,0,0,0,1,0.0,1,1,0,1,0,0,9,1
Jack Grealish,"FW,MF",Manchester City,eng Premier League,27,11.2,13,8,6,7,0,6,12,50.0,6,13,2,11,6,19,5,0
Mason Greenwood,"MF,FW",Getafe,es La Liga,21,29.6,11,6,3,5,3,4,21,19.0,17,9,0,9,4,15,4,0
Michael Gregoritsch,FW,Freiburg,de Bundesliga,29,18.7,16,12,8,5,3,2,14,14.3,12,17,4,13,9,25,27,0
Antoine Griezmann,"FW,MF",Atlético Madrid,es La Liga,32,29.4,33,19,14,14,5,15,41,36.6,26,34,3,31,10,43,23,1
Vincenzo Grifo,"MF,FW",Freiburg,de Bundesliga,30,25.8,31,20,14,11,6,14,31,45.2,17,22,1,21,15,46,20,0
Florian Grillitsch,"DF,MF",Hoffenheim,de Bundesliga,27,25.5,54,28,31,19,4,22,54,40.7,32,41,20,21,52,106,90,2
Álex Grimaldo,DF,Leverkusen,de Bundesliga,27,30.9,45,24,26,10,9,30,55,54.5,25,32,7,25,22,67,41,0
Christian Groß,"DF,MF",Werder Bremen,de Bundesliga,34,8.9,21,16,11,9,1,11,25,44.0,14,17,6,11,13,34,28,1
Pascal Groß,"MF,DF",Brighton,eng Premier League,32,34.6,70,46,33,21,16,31,72,43.1,41,41,8,33,22,92,32,3
Brajan Gruda,"MF,FW",Mainz 05,de Bundesliga,19,18.2,22,14,5,11,6,14,24,58.3,10,15,0,15,5,27,4,0
Vicente Guaita,GK,Celta Vigo,es La Liga,36,26.7,1,1,1,0,0,1,2,50.0,1,0,0,0,0,1,9,1
Andrés Guardado,MF,Betis,es La Liga,36,5.0,17,12,5,9,3,7,14,50.0,7,4,2,2,6,23,5,0
Sergi Guardiola,"FW,MF",Cádiz,es La Liga,32,5.5,10,7,2,6,2,4,9,44.4,5,10,0,10,0,10,4,0
Nemanja Gudelj,"DF,MF",Sevilla,es La Liga,31,19.4,31,24,18,10,3,17,31,54.8,14,17,9,8,27,58,56,0
Gabriel Gudmundsson,"DF,FW",Lille,fr Ligue 1,24,14.1,22,16,7,13,2,12,20,60.0,8,14,3,11,15,37,25,0
Gonçalo Guedes,"FW,MF",Villarreal,es La Liga,26,10.6,6,4,1,2,3,2,7,28.6,5,8,0,8,2,8,3,0
Marc Guéhi,DF,Crystal Palace,eng Premier League,23,22.5,28,19,21,7,0,14,24,58.3,10,22,17,5,18,46,89,1
Mattéo Guendouzi,MF,Lazio,it Serie A,24,26.3,34,15,11,18,5,21,49,42.9,28,24,6,18,21,55,24,1
Javier Guerra,MF,Valencia,es La Liga,20,27.8,54,24,25,22,7,22,58,37.9,36,27,7,20,18,72,44,0
Raphaël Guerreiro,"DF,MF",Bayern Munich,de Bundesliga,29,13.2,19,16,6,9,4,9,15,60.0,6,7,1,6,15,34,5,1
Evann Guessand,FW,Nice,fr Ligue 1,22,17.3,16,7,2,7,7,6,7,85.7,1,12,1,11,12,28,7,0
Ander Guevara,MF,Alavés,es La Liga,26,32.6,59,32,28,25,6,31,64,48.4,33,34,12,22,13,72,46,1
Pape Gueye,"MF,DF",Marseille,fr Ligue 1,24,8.5,33,21,11,19,3,13,19,68.4,6,17,3,14,13,46,12,0
Josuha Guilavogui,DF,Mainz 05,de Bundesliga,32,4.5,15,10,10,5,0,6,7,85.7,1,13,7,6,13,28,21,0
Morgan Guilavogui,"FW,MF",Lens,fr Ligue 1,25,6.3,21,10,4,12,5,5,11,45.5,6,11,2,9,4,25,7,0
Frederic Guilbert,"DF,MF",Strasbourg,fr Ligue 1,28,27.7,87,50,49,30,8,47,72,65.3,25,39,10,29,71,158,99,1
Hugo Guillamón,MF,Valencia,es La Liga,23,14.6,24,15,7,14,3,11,17,64.7,6,8,3,5,12,36,25,2
Bruno Guimarães,MF,Newcastle Utd,eng Premier League,25,36.3,88,53,45,32,11,40,77,51.9,37,52,14,38,35,123,20,0
Serhou Guirassy,FW,Stuttgart,de Bundesliga,27,24.5,6,3,1,4,1,2,5,40.0,3,8,1,7,6,12,29,0
Péter Gulácsi,GK,RB Leipzig,de Bundesliga,33,13.0,0,0,0,0,0,0,0,,0,0,0,0,0,0,8,1
Manuel Gulde,DF,Freiburg,de Bundesliga,32,22.7,37,23,23,13,1,17,23,73.9,6,24,14,10,25,62,82,0
Arda Güler,"FW,MF",Real Madrid,es La Liga,18,4.2,6,4,1,3,2,5,8,62.5,3,0,0,0,2,8,5,0
Gerard Gumbau,MF,Granada,es La Liga,28,29.7,55,34,21,30,4,23,62,37.1,39,24,5,19,25,80,30,2
Robert Gumny,DF,Augsburg,de Bundesliga,25,5.3,6,5,1,3,2,1,5,20.0,4,13,5,8,7,13,15,0
İlkay Gündoğan,MF,Barcelona,es La Liga,32,33.3,32,22,14,16,2,12,39,30.8,27,19,4,15,21,53,18,1
Christian Günter,DF,Freiburg,de Bundesliga,30,11.8,20,12,9,11,0,7,18,38.9,11,9,3,6,2,22,16,0
Jon Guridi,MF,Alavés,es La Liga,28,29.8,42,24,10,27,5,12,45,26.7,33,23,3,20,22,64,22,0
Gorka Guruzeta,FW,Athletic Club,es La Liga,26,24.6,34,23,6,25,3,9,30,30.0,21,36,2,34,17,51,23,0
Malo Gusto,DF,Chelsea,eng Premier League,20,19.5,55,27,34,15,6,35,52,67.3,17,28,4,24,17,72,43,1
Miguel Gutiérrez,DF,Girona,es La Liga,22,33.7,29,18,11,14,4,13,35,37.1,22,27,11,16,22,51,66,2
Albert Guðmundsson,"FW,MF",Genoa,it Serie A,26,33.5,23,10,8,10,5,12,44,27.3,32,15,2,13,11,34,13,0
Joško Gvardiol,DF,Manchester City,eng Premier League,21,25.9,55,33,21,24,10,21,38,55.3,17,36,12,24,27,82,37,3
Emmanuel Gyasi,"DF,FW",Empoli,it Serie A,29,20.9,34,17,18,13,3,15,32,46.9,17,30,12,18,5,39,27,1
Norbert Gyömbér,DF,Salernitana,it Serie A,31,19.6,36,18,30,6,0,20,26,76.9,6,33,23,10,23,59,77,2
Erling Haaland,FW,Manchester City,eng Premier League,23,28.4,6,3,0,3,3,2,3,66.7,1,11,1,10,2,8,16,0
Janik Haberer,"MF,DF",Union Berlin,de Bundesliga,29,13.6,36,24,16,13,7,22,45,48.9,23,21,4,17,12,48,18,0
Robin Hack,"FW,MF",Gladbach,de Bundesliga,24,15.0,15,8,6,7,2,4,17,23.5,13,16,0,16,14,29,21,0
Munir El Haddadi,FW,Las Palmas,es La Liga,27,27.2,40,27,18,17,5,17,38,44.7,21,27,1,26,11,51,16,0
Ianis Hagi,"MF,FW",Alavés,es La Liga,24,8.9,17,12,2,14,1,5,12,41.7,7,8,0,8,5,22,4,0
Amadou Haidara,MF,RB Leipzig,de Bundesliga,25,17.0,42,27,24,16,2,23,41,56.1,18,28,6,22,21,63,37,0
Massadio Haïdara,DF,Lens,fr Ligue 1,30,8.2,9,8,5,3,1,4,6,66.7,2,7,2,5,11,20,32,3
Oualid El Hajjam,"DF,MF",Le Havre,fr Ligue 1,32,4.4,8,7,5,2,1,2,9,22.2,7,5,1,4,6,14,10,0
Achraf Hakimi,DF,Paris S-G,fr Ligue 1,24,21.5,29,19,14,9,6,17,34,50.0,17,28,4,24,12,41,28,2
Lewis Hall,DF,Newcastle Utd,eng Premier League,18,8.7,28,18,17,10,1,17,28,60.7,11,17,2,15,12,40,22,1
Sébastien Haller,FW,Dortmund,de Bundesliga,29,4.4,1,0,0,1,0,1,1,100.0,0,4,1,3,0,1,7,0
Gustavo Hamer,MF,Sheffield Utd,eng Premier League,26,32.3,39,21,17,15,7,16,59,27.1,43,33,9,24,29,68,35,0
Andreas Hanche-Olsen,DF,Mainz 05,de Bundesliga,26,11.0,20,12,10,8,2,10,16,62.5,6,10,4,6,11,31,41,0
Ridgeciano Haps,DF,Genoa,it Serie A,30,8.6,7,6,3,2,2,5,8,62.5,3,3,0,3,6,13,11,1
Amine Harit,"MF,FW",Marseille,fr Ligue 1,26,20.2,28,16,8,17,3,13,37,35.1,24,31,4,27,12,40,4,0
Jack Harrison,"MF,FW",Everton,eng Premier League,26,24.6,37,22,12,12,13,17,49,34.7,32,25,5,20,12,49,24,0
Abdou Harroui,"MF,FW",Frosinone,it Serie A,25,11.3,23,11,11,11,1,8,16,50.0,8,19,3,16,5,28,8,0
Daiki Hashioka,DF,Luton Town,eng Premier League,24,6.6,11,5,6,4,1,5,11,45.5,6,12,7,5,8,19,20,0
Hans Hateboer,DF,Atalanta,it Serie A,29,12.4,12,5,8,2,2,5,15,33.3,10,21,7,14,4,16,21,0
Pantelis Hatzidiakos,DF,Cagliari,it Serie A,26,9.5,22,10,12,10,0,10,17,58.8,7,14,5,9,13,35,30,1
Kai Havertz,"MF,FW",Arsenal,eng Premier League,24,29.3,35,15,7,21,7,14,39,35.9,25,26,1,25,20,55,22,0
Jan Paul van Hecke,DF,Brighton,eng Premier League,23,26.3,47,26,25,19,3,27,45,60.0,18,49,27,22,30,77,76,4
Hwang Hee-chan,"FW,MF",Wolves,eng Premier League,27,23.5,20,10,11,8,1,9,24,37.5,15,19,1,18,10,30,9,0
Silvan Hefti,"DF,FW",Montpellier,fr Ligue 1,25,7.9,21,15,10,7,4,15,29,51.7,14,7,2,5,8,29,11,0
Dominique Heintz,DF,Köln,de Bundesliga,29,6.3,12,5,6,6,0,8,12,66.7,4,6,1,5,3,15,28,0
Dean Henderson,GK,Crystal Palace,eng Premier League,26,18.0,1,1,1,0,0,1,2,50.0,1,0,0,0,0,1,8,2
Benjamin Henrichs,DF,RB Leipzig,de Bundesliga,26,28.1,68,39,32,26,10,27,58,46.6,31,49,4,45,33,101,37,0
Henrique,DF,Lyon,fr Ligue 1,29,6.7,10,6,6,4,0,6,11,54.5,5,8,2,6,10,20,3,0
Luis Henrique,"FW,DF",Marseille,fr Ligue 1,21,8.7,8,7,4,1,3,4,7,57.1,3,9,0,9,8,16,3,0
Luiz Henrique,FW,Betis,es La Liga,22,6.8,15,11,4,10,1,9,14,64.3,5,11,0,11,5,20,8,0
Matheus Henrique,MF,Sassuolo,it Serie A,25,27.8,43,29,21,18,4,18,43,41.9,25,18,8,10,25,68,31,6
Rico Henry,DF,Brentford,eng Premier League,26,4.5,7,5,3,3,1,6,7,85.7,1,8,3,5,5,12,5,1
Christophe Hérelle,DF,Metz,fr Ligue 1,30,18.0,32,15,24,7,1,13,23,56.5,10,16,9,7,18,50,68,2
Mario Hermoso,DF,Atlético Madrid,es La Liga,28,28.4,46,25,29,13,4,28,51,54.9,23,27,9,18,30,76,93,0
Javi Hernández,DF,Cádiz,es La Liga,25,27.9,43,24,26,12,5,25,46,54.3,21,34,9,25,19,62,72,1
Aridane Hernández,DF,Rayo Vallecano,es La Liga,34,18.8,10,8,5,4,1,4,11,36.4,7,19,14,5,14,24,98,1
Lucas Hernández,DF,Paris S-G,fr Ligue 1,27,21.2,52,36,28,15,9,29,50,58.0,21,21,5,16,27,79,38,0
Luis Hernández,DF,Cádiz,es La Liga,34,8.0,7,3,4,3,0,4,8,50.0,4,3,2,1,8,15,25,0
Theo Hernández,DF,Milan,it Serie A,25,31.0,30,17,19,11,0,11,22,50.0,11,33,13,20,23,53,42,1
Yarek Hernandis,DF,Valencia,es La Liga,18,8.2,22,12,14,5,3,13,19,68.4,6,15,8,7,15,37,50,1
Jorge Herrando,DF,Osasuna,es La Liga,22,18.3,29,19,23,6,0,12,19,63.2,7,20,11,9,15,44,69,1
Ander Herrera,MF,Athletic Club,es La Liga,33,11.4,44,32,11,26,7,20,36,55.6,16,16,6,10,15,59,18,1
Sergio Herrera,GK,Osasuna,es La Liga,30,31.9,2,2,2,0,0,2,3,66.7,1,0,0,0,0,2,22,3
Yangel Herrera,MF,Girona,es La Liga,25,23.4,64,37,28,30,6,30,56,53.6,26,30,8,22,24,88,45,1
Son Heung-min,FW,Tottenham,eng Premier League,31,32.6,21,13,6,7,8,10,21,47.6,11,4,1,3,8,29,4,0
Aaron Hickey,DF,Brentford,eng Premier League,21,7.9,16,9,9,3,4,7,7,100.0,0,7,3,4,3,19,10,0
Isak Hien,DF,Hellas Verona,it Serie A,24,9.6,17,10,10,7,0,10,19,52.6,9,12,5,7,7,24,33,1
Isak Hien,DF,Atalanta,it Serie A,24,10.4,18,12,8,10,0,7,15,46.7,8,12,5,7,14,32,33,0
Piero Hincapié,DF,Leverkusen,de Bundesliga,21,16.5,35,22,14,17,4,13,17,76.5,4,18,7,11,13,48,43,0
Jack Hinshelwood,DF,Brighton,eng Premier League,18,9.7,14,5,7,4,3,5,13,38.5,8,6,2,4,14,28,18,0
Adam Hložek,"MF,FW",Leverkusen,de Bundesliga,21,5.1,10,4,2,4,4,3,7,42.9,4,4,1,3,2,12,1,0
Nicolas Höfler,MF,Freiburg,de Bundesliga,33,25.9,63,40,36,20,7,22,49,44.9,27,30,16,14,31,94,45,0
Jonas Hofmann,MF,Leverkusen,de Bundesliga,31,24.5,20,14,6,9,5,10,24,41.7,14,18,0,18,8,28,6,0
Philipp Hofmann,FW,Bochum,de Bundesliga,30,17.5,10,5,4,5,1,4,7,57.1,3,11,2,9,4,14,17,0
Lucas Höler,"FW,MF",Freiburg,de Bundesliga,29,25.6,32,24,14,10,8,4,23,17.4,19,19,4,15,15,47,35,0
Mason Holgate,DF,Sheffield Utd,eng Premier League,26,7.9,12,7,5,6,1,5,12,41.7,7,12,5,7,11,23,40,0
Fabian Holland,"MF,DF",Darmstadt 98,de Bundesliga,33,20.4,47,26,18,21,8,20,37,54.1,17,22,12,10,24,71,29,0
Benedict Hollerbach,"FW,MF",Union Berlin,de Bundesliga,22,14.2,17,11,5,7,5,7,22,31.8,15,28,0,28,4,21,3,0
Emil Holm,DF,Atalanta,it Serie A,23,10.5,28,19,17,9,2,16,36,44.4,20,25,3,22,7,35,25,0
Gerrit Holtmann,"MF,FW",Darmstadt 98,de Bundesliga,28,4.4,8,5,3,4,1,7,10,70.0,3,7,0,7,2,10,4,1
Martin Hongla,MF,Hellas Verona,it Serie A,25,12.0,24,13,9,13,2,8,11,72.7,3,8,3,5,7,31,24,0
Martin Hongla,"MF,DF",Granada,es La Liga,25,6.2,7,3,2,5,0,3,9,33.3,6,6,3,3,6,13,13,1
Franck Honorat,"DF,FW",Gladbach,de Bundesliga,26,26.1,25,13,13,10,2,11,20,55.0,9,22,3,19,9,34,35,1
Mathias Honsak,"FW,MF",Darmstadt 98,de Bundesliga,26,11.3,14,7,7,6,1,6,20,30.0,14,14,2,12,8,22,25,0
Lukáš Hrádecký,GK,Leverkusen,de Bundesliga,33,33.0,0,0,0,0,0,0,1,0.0,1,1,0,1,0,0,10,2
Timo Hübers,DF,Köln,de Bundesliga,27,30.9,68,47,51,14,3,49,80,61.3,31,54,28,26,63,131,168,1
Callum Hudson-Odoi,"FW,MF",Nott'ham Forest,eng Premier League,22,20.6,18,8,4,5,9,7,28,25.0,21,16,1,15,7,25,12,1
Will Hughes,MF,Crystal Palace,eng Premier League,28,21.0,61,33,30,20,11,24,48,50.0,24,36,14,22,21,82,25,0
Dean Huijsen,DF,Roma,it Serie A,18,5.7,10,5,5,5,0,1,4,25.0,3,7,4,3,4,14,26,2
Mats Hummels,DF,Dortmund,de Bundesliga,34,17.6,52,34,34,12,6,30,53,56.6,23,33,11,22,33,85,82,0
Denis Huseinbasic,MF,Köln,de Bundesliga,22,18.1,38,18,17,15,6,20,31,64.5,11,26,1,25,13,51,14,0
Elseid Hysaj,DF,Lazio,it Serie A,29,13.3,24,14,8,13,3,15,24,62.5,9,16,6,10,17,41,31,0
Pierre Højbjerg,MF,Tottenham,eng Premier League,27,14.6,32,18,13,17,2,13,34,38.2,21,21,7,14,19,51,30,3
Rasmus Højlund,FW,Manchester Utd,eng Premier League,20,24.0,11,7,2,3,6,5,13,38.5,8,9,1,8,1,12,19,0
Iago,DF,Augsburg,de Bundesliga,26,18.0,36,17,22,10,4,17,33,51.5,16,39,8,31,18,54,43,0
Pablo Ibáñez,MF,Osasuna,es La Liga,24,12.8,18,9,5,7,6,5,21,23.8,16,26,3,23,9,27,17,0
Arijon Ibrahimović,"FW,DF",Frosinone,it Serie A,17,5.3,7,6,4,2,1,1,9,11.1,8,4,0,4,1,8,3,0
Iglesias,"DF,FW",Getafe,es La Liga,25,15.7,41,22,25,11,5,21,33,63.6,12,18,7,11,16,57,53,0
Borja Iglesias,FW,Betis,es La Liga,30,4.5,0,0,0,0,0,0,3,0.0,3,0,0,0,2,2,2,0
Igor,DF,Brighton,eng Premier League,25,18.2,25,18,7,16,2,17,29,58.6,12,22,9,13,14,39,52,1
Jonathan Ikone,FW,Fiorentina,it Serie A,25,18.7,22,11,7,9,6,10,17,58.8,7,12,0,12,3,25,8,0
Chukwubuikem Ikwuemesi,FW,Salernitana,it Serie A,21,11.8,3,1,0,2,1,2,6,33.3,4,1,1,0,1,4,8,0
Ivan Ilić,MF,Torino,it Serie A,22,23.3,22,8,9,10,3,13,27,48.1,14,20,7,13,20,42,31,0
Samuel Iling-Junior,"DF,MF",Juventus,it Serie A,19,9.0,23,13,9,11,3,11,18,61.1,7,17,5,12,6,29,19,0
Imanol,DF,Athletic Club,es La Liga,23,5.8,7,5,1,5,1,5,18,27.8,13,6,0,6,7,14,15,0
Ciro Immobile,FW,Lazio,it Serie A,33,18.4,11,9,2,5,4,3,14,21.4,11,9,3,6,5,16,11,0
Danny Ings,FW,West Ham,eng Premier League,31,4.5,6,2,0,6,0,4,13,30.8,9,4,1,3,3,9,7,0
Alexander Isak,FW,Newcastle Utd,eng Premier League,23,25.1,5,0,2,1,2,2,8,25.0,6,16,1,15,6,11,13,0
Gustav Isaksen,FW,Lazio,it Serie A,22,11.9,4,3,2,1,1,1,9,11.1,8,11,1,10,4,8,4,0
Isco,MF,Betis,es La Liga,31,25.8,41,27,15,21,5,14,38,36.8,24,19,1,18,10,51,7,0
Thomas Isherwood,DF,Darmstadt 98,de Bundesliga,25,7.1,11,5,7,3,1,5,9,55.6,4,10,7,3,10,21,34,0
Ismaily,DF,Lille,fr Ligue 1,33,27.4,72,47,34,25,13,31,60,51.7,29,33,6,27,32,104,77,0
Ardian Ismajli,DF,Empoli,it Serie A,26,22.7,26,16,18,6,2,18,23,78.3,5,28,17,11,23,49,126,1
Ko Itakura,"DF,MF",Gladbach,de Bundesliga,26,17.7,34,21,17,15,2,16,26,61.5,10,32,18,14,22,56,62,0
Hiroki Ito,DF,Stuttgart,de Bundesliga,24,24.8,19,18,13,6,0,11,26,42.3,15,29,17,12,29,48,86,2
Junya Ito,"FW,MF",Reims,fr Ligue 1,30,30.2,33,15,11,14,8,10,36,27.8,26,23,1,22,14,47,7,0
Alex Iwobi,"FW,MF",Fulham,eng Premier League,27,24.4,29,18,12,15,2,12,25,48.0,13,16,0,16,14,43,9,0
Armando Izzo,DF,Monza,it Serie A,31,18.3,27,17,17,9,1,16,27,59.3,11,20,16,4,27,54,49,1
Nicolas Jackson,FW,Chelsea,eng Premier League,22,31.1,21,13,5,8,8,5,24,20.8,19,20,5,15,4,25,17,0
Lee Jae-sung,"MF,FW",Mainz 05,de Bundesliga,30,23.5,33,20,11,16,6,13,39,33.3,26,22,2,20,27,60,23,0
Kristijan Jakić,MF,Augsburg,de Bundesliga,26,11.7,28,14,14,10,4,15,33,45.5,18,13,1,12,20,48,15,0
Ismail Jakobs,DF,Monaco,fr Ligue 1,23,16.3,57,41,27,21,9,29,47,61.7,18,19,2,17,11,68,40,0
Ablie Jallow,"MF,FW",Metz,fr Ligue 1,24,10.2,8,5,2,3,3,3,5,60.0,2,4,0,4,8,16,3,0
Reece James,DF,Chelsea,eng Premier League,23,4.7,14,9,10,3,1,8,10,80.0,2,4,4,0,3,17,7,1
Vitaly Janelt,"MF,DF",Brentford,eng Premier League,25,33.9,63,38,29,25,9,32,64,50.0,32,35,9,26,36,99,64,3
Jakub Jankto,"MF,FW",Cagliari,it Serie A,27,9.7,12,9,9,1,2,8,20,40.0,12,5,1,4,5,17,20,0
Luis Javier Suárez,FW,Almería,es La Liga,25,10.2,7,5,2,5,0,2,6,33.3,4,11,0,11,0,7,13,0
Danley Jean-Jacques,MF,Metz,fr Ligue 1,23,29.8,54,28,24,21,9,19,56,33.9,37,48,7,41,44,98,44,0
Fredrik Jensen,"MF,FW",Augsburg,de Bundesliga,25,14.9,23,11,9,8,6,14,28,50.0,14,30,1,29,12,35,21,0
Mathias Jensen,MF,Brentford,eng Premier League,27,24.5,54,32,25,22,7,26,95,27.4,69,41,6,35,23,77,25,1
Moritz Jenz,DF,Wolfsburg,de Bundesliga,24,19.4,34,24,21,11,2,14,21,66.7,7,29,17,12,26,60,94,0
Gabriel Jesus,FW,Arsenal,eng Premier League,26,16.4,24,17,11,5,8,5,18,27.8,13,23,1,22,13,37,12,0
Juan Jesus,DF,Napoli,it Serie A,32,23.5,42,19,28,12,2,23,33,69.7,10,23,12,11,23,65,67,1
Raúl Jiménez,FW,Fulham,eng Premier League,32,15.5,18,12,4,8,6,7,20,35.0,13,11,3,8,4,22,13,0
João Pedro,"FW,MF",Brighton,eng Premier League,21,22.7,31,14,10,13,8,14,24,58.3,10,15,2,13,11,42,28,0
Joelinton,"MF,FW",Newcastle Utd,eng Premier League,26,14.2,39,27,21,15,3,14,38,36.8,24,23,7,16,19,58,11,1
Ryan John Giles,"DF,MF",Luton Town,eng Premier League,23,5.6,8,6,4,3,1,2,7,28.6,5,2,0,2,4,12,22,0
Ben Johnson,"DF,FW",West Ham,eng Premier League,23,6.0,11,7,7,3,1,9,14,64.3,5,2,1,1,5,16,14,0
Brennan Johnson,FW,Tottenham,eng Premier League,22,23.2,26,15,14,5,7,12,31,38.7,19,37,1,36,10,36,12,1
Sam Johnstone,GK,Crystal Palace,eng Premier League,30,20.0,1,0,1,0,0,1,1,100.0,0,0,0,0,1,2,5,0
Curtis Jones,MF,Liverpool,eng Premier League,22,13.0,27,14,12,12,3,10,23,43.5,13,22,0,22,7,34,8,0
Frenkie de Jong,MF,Barcelona,es La Liga,26,18.2,43,26,14,23,6,8,19,42.1,11,18,8,10,14,57,28,1
Joan Jordán,MF,Sevilla,es La Liga,29,4.2,8,7,3,3,2,7,15,46.7,8,4,2,2,4,12,2,0
Jordi,"MF,DF",Getafe,es La Liga,22,6.4,16,11,3,11,2,7,15,46.7,8,7,2,5,8,24,7,0
Kaio Jorge,FW,Frosinone,it Serie A,21,9.0,6,4,0,1,5,3,4,75.0,1,6,0,6,1,7,0,0
Jorginho,MF,Arsenal,eng Premier League,31,10.2,24,10,6,10,8,11,23,47.8,12,17,1,16,12,36,7,1
Willian José,FW,Betis,es La Liga,31,21.9,7,3,1,2,4,2,5,40.0,3,8,2,6,2,9,15,0
Joselu,FW,Real Madrid,es La Liga,33,18.7,6,3,1,4,1,0,7,0.0,7,11,1,10,6,12,11,0
Diogo Jota,FW,Liverpool,eng Premier League,26,12.7,23,13,6,13,4,10,23,43.5,13,9,1,8,7,30,4,0
Antoine Joujou,"FW,MF",Le Havre,fr Ligue 1,20,8.7,20,12,7,7,6,11,21,52.4,10,11,2,9,7,27,5,0
Luka Jović,FW,Milan,it Serie A,25,9.7,6,4,0,3,3,4,6,66.7,2,3,0,3,1,7,9,0
Kamil Jóźwiak,MF,Granada,es La Liga,25,6.3,13,10,4,6,3,9,17,52.9,8,4,0,4,2,15,6,0
Juanmi,FW,Cádiz,es La Liga,30,9.7,9,4,2,7,0,2,9,22.2,7,6,0,6,6,15,3,0
Juanpe,DF,Girona,es La Liga,32,8.3,11,8,8,3,0,9,10,90.0,1,17,11,6,7,18,50,1
Mads Juel Andersen,DF,Luton Town,eng Premier League,25,4.4,6,5,4,2,0,4,4,100.0,0,9,6,3,8,14,29,0
Christopher Jullien,DF,Montpellier,fr Ligue 1,30,13.7,16,12,11,5,0,6,17,35.3,11,25,20,5,12,28,106,2
Anthony Jung,DF,Werder Bremen,de Bundesliga,31,28.7,37,23,21,14,2,18,33,54.5,15,39,17,22,24,61,102,0
Eli Junior Kroupi,"FW,MF",Lorient,fr Ligue 1,17,12.0,7,4,2,2,3,1,9,11.1,8,6,0,6,10,17,5,0
Hamed Junior Traorè,MF,Napoli,it Serie A,23,4.2,4,2,2,0,2,1,6,16.7,5,3,0,3,2,6,1,1
Vinicius Júnior,FW,Real Madrid,es La Liga,23,20.7,18,13,5,5,8,3,12,25.0,9,13,0,13,1,19,3,2
Josip Juranović,DF,Union Berlin,de Bundesliga,27,14.4,20,14,11,7,2,10,21,47.6,11,17,3,14,12,32,27,1
David Jurásek,DF,Hoffenheim,de Bundesliga,22,5.5,14,11,13,1,0,7,17,41.2,10,7,2,5,3,17,22,1
Julian Justvan,"MF,FW",Darmstadt 98,de Bundesliga,25,11.4,10,4,2,7,1,3,17,17.6,14,12,2,10,11,21,6,1
Filip Jørgensen,GK,Villarreal,es La Liga,21,36.0,3,1,3,0,0,3,4,75.0,1,0,0,0,2,5,10,3
Mathias Jørgensen,DF,Brentford,eng Premier League,33,12.1,17,12,15,1,1,11,19,57.9,8,9,5,4,12,29,40,0
Mohamed Kaba,MF,Lecce,it Serie A,21,15.3,39,23,15,16,8,17,34,50.0,17,22,4,18,12,51,13,0
Sory Kaba,FW,Las Palmas,es La Liga,28,8.0,2,0,0,2,0,0,5,0.0,5,6,0,6,0,2,9,0
Ozan Kabak,DF,Hoffenheim,de Bundesliga,23,25.4,48,35,32,14,2,19,33,57.6,14,43,21,22,46,94,106,2
Christian Kabasele,DF,Udinese,it Serie A,32,9.6,10,7,4,5,1,2,11,18.2,9,15,9,6,12,22,56,0
Issa Kaboré,DF,Luton Town,eng Premier League,22,19.2,52,28,23,21,8,24,45,53.3,21,22,11,11,16,68,56,2
Abdoul Kader Bamba,"FW,MF",Nantes,fr Ligue 1,29,6.8,10,7,2,5,3,5,15,33.3,10,4,0,4,4,14,4,1
Pavel Kadeřábek,"DF,FW",Hoffenheim,de Bundesliga,31,26.8,31,19,10,15,6,18,40,45.0,22,22,8,14,23,54,68,0
Tino Kadewere,"FW,MF",Nantes,fr Ligue 1,27,8.7,9,4,3,3,3,6,11,54.5,5,10,1,9,10,19,8,0
Kaiky,DF,Almería,es La Liga,19,5.8,7,4,6,0,1,3,6,50.0,3,9,7,2,3,10,29,1
Florian Kainz,"MF,FW",Köln,de Bundesliga,30,24.4,28,20,8,13,7,17,39,43.6,22,20,6,14,13,41,23,1
Arnaud Kalimuendo,FW,Rennes,fr Ligue 1,21,23.8,5,4,2,2,1,2,5,40.0,3,13,2,11,4,9,4,0
Gedeon Kalulu,DF,Lorient,fr Ligue 1,25,10.8,23,17,13,8,2,12,22,54.5,10,18,2,16,5,28,30,0
Pierre Kalulu,DF,Milan,it Serie A,23,4.2,5,1,2,3,0,1,2,50.0,1,4,3,1,1,6,12,1
Daichi Kamada,MF,Lazio,it Serie A,26,17.2,53,36,22,22,9,28,52,53.8,24,24,5,19,18,71,7,0
Waren Kamanzi,"DF,FW",Toulouse,fr Ligue 1,22,13.2,36,24,16,16,4,13,23,56.5,10,11,3,8,9,45,35,0
Boubacar Kamara,MF,Aston Villa,eng Premier League,23,18.4,43,29,16,21,6,24,47,51.1,23,21,7,14,21,64,16,0
Hassane Kamara,DF,Udinese,it Serie A,29,24.7,45,32,26,13,6,25,38,65.8,13,29,2,27,26,71,66,0
Jakub Kamiński,"FW,MF",Wolfsburg,de Bundesliga,21,5.3,14,5,12,2,0,3,6,50.0,3,3,0,3,2,16,5,0
Thomas Kaminski,GK,Luton Town,eng Premier League,30,37.8,2,1,2,0,0,2,6,33.3,4,1,0,1,0,2,14,2
Kevin Kampl,MF,RB Leipzig,de Bundesliga,32,15.1,19,8,8,9,2,10,21,47.6,11,19,7,12,11,30,14,1
Harry Kane,FW,Bayern Munich,de Bundesliga,30,31.5,13,9,4,4,5,6,18,33.3,12,12,4,8,6,19,14,0
Lee Kang-in,"FW,MF",Paris S-G,fr Ligue 1,22,16.3,26,13,7,9,10,15,36,41.7,21,7,0,7,6,32,3,0
Atakan Karazor,MF,Stuttgart,de Bundesliga,26,29.1,72,44,23,38,11,29,60,48.3,31,37,8,29,27,99,43,0
Ayman Kari,MF,Lorient,fr Ligue 1,18,9.9,18,14,9,9,0,12,19,63.2,7,19,2,17,6,24,9,1
Emir Karic,DF,Darmstadt 98,de Bundesliga,26,19.8,45,27,23,14,8,21,33,63.6,12,42,11,31,13,58,43,0
Rick Karsdorp,DF,Roma,it Serie A,28,13.2,25,18,11,8,6,16,24,66.7,8,13,4,9,9,34,16,0
Grigoris Kastanos,"MF,DF",Salernitana,it Serie A,25,16.4,23,14,8,9,6,9,20,45.0,11,13,4,9,8,31,9,0
Silas Katompa,"FW,MF",Stuttgart,de Bundesliga,24,10.0,5,3,3,2,0,3,12,25.0,9,9,0,9,0,5,4,0
Panos Katseris,DF,Lorient,fr Ligue 1,22,11.6,26,20,16,8,2,16,25,64.0,9,20,4,16,8,34,18,0
Mikkel Kaufmann,FW,Union Berlin,de Bundesliga,22,5.4,6,3,2,3,1,3,10,30.0,7,12,0,12,1,7,4,0
Michael Kayode,DF,Fiorentina,it Serie A,19,22.9,53,30,27,15,11,35,48,72.9,13,25,12,13,18,71,46,2
Moise Kean,FW,Juventus,it Serie A,23,7.3,7,4,3,2,2,1,3,33.3,2,4,1,3,2,9,5,0
Michael Keane,DF,Everton,eng Premier League,30,4.9,7,3,3,3,1,1,7,14.3,6,5,4,1,5,12,18,1
Kévin Keben Biakolo,DF,Toulouse,fr Ligue 1,19,5.8,4,2,4,0,0,3,6,50.0,3,7,0,7,8,12,17,0
Yassine Kechta,MF,Le Havre,fr Ligue 1,21,20.5,46,24,24,19,3,31,73,42.5,42,20,3,17,23,69,16,1
Thilo Kehrer,DF,Monaco,fr Ligue 1,26,14.7,32,22,22,7,3,22,39,56.4,17,18,6,12,30,62,55,0
Habib Keita,MF,Clermont Foot,fr Ligue 1,21,14.2,34,19,14,15,5,17,28,60.7,11,27,10,17,29,63,30,0
Yannik Keitel,"DF,MF",Freiburg,de Bundesliga,23,10.2,20,15,14,5,1,10,15,66.7,5,17,8,9,12,32,44,3
Caoimhín Kelleher,GK,Liverpool,eng Premier League,24,10.0,0,0,0,0,0,0,0,,0,0,0,0,0,0,4,1
Lloyd Kelly,DF,Bournemouth,eng Premier League,24,17.3,24,19,10,9,5,14,25,56.0,11,22,12,10,13,37,67,0
Tobias Kempe,MF,Darmstadt 98,de Bundesliga,34,15.0,20,13,9,8,3,8,24,33.3,16,16,4,12,9,29,12,0
Milos Kerkez,DF,Bournemouth,eng Premier League,19,21.9,47,26,31,13,3,30,42,71.4,12,31,11,20,20,67,60,2
Reda Khadra,"FW,MF",Reims,fr Ligue 1,22,15.2,16,10,5,4,7,8,20,40.0,12,8,2,6,3,19,13,0
Wahbi Khazri,FW,Montpellier,fr Ligue 1,32,12.6,24,17,8,12,4,14,35,40.0,21,10,0,10,3,27,7,0
Rani Khedira,MF,Union Berlin,de Bundesliga,29,14.9,35,22,15,19,1,17,26,65.4,9,12,5,7,22,57,38,0
Abdukodir Khusanov,DF,Lens,fr Ligue 1,19,9.0,21,12,13,8,0,9,17,52.9,8,13,8,5,13,34,32,2
Kiké,"FW,MF",Alavés,es La Liga,33,15.8,8,4,2,3,3,4,9,44.4,5,16,5,11,1,9,12,0
Luca Kilian,DF,Köln,de Bundesliga,23,7.1,16,9,15,1,0,9,14,64.3,5,12,5,7,7,23,28,0
Max Kilman,DF,Wolves,eng Premier League,26,38.0,47,21,40,6,1,24,32,75.0,8,64,37,27,39,86,182,4
Joshua Kimmich,"MF,DF",Bayern Munich,de Bundesliga,28,24.2,45,33,25,15,5,26,39,66.7,13,32,4,28,14,59,28,1
Jakub Kiwior,DF,Arsenal,eng Premier League,23,10.5,20,12,11,8,1,14,19,73.7,5,11,3,8,8,28,28,1
Simon Kjær,DF,Milan,it Serie A,34,13.0,24,15,11,11,2,14,22,63.6,8,22,16,6,14,38,46,2
Christoph Klarer,DF,Darmstadt 98,de Bundesliga,23,26.2,37,22,30,4,3,24,36,66.7,12,31,20,11,21,58,94,1
Tim Kleindienst,FW,Heidenheim,de Bundesliga,27,31.9,21,12,6,11,4,7,25,28.0,18,32,8,24,12,33,58,0
Lukas Klostermann,DF,RB Leipzig,de Bundesliga,27,16.0,15,10,7,7,1,4,13,30.8,9,25,12,13,13,28,64,1
Justin Kluivert,"MF,FW",Bournemouth,eng Premier League,24,21.3,28,14,5,12,11,8,30,26.7,22,16,1,15,8,36,11,0
Ansgar Knauff,"MF,DF",Eint Frankfurt,de Bundesliga,21,23.4,43,26,17,16,10,17,31,54.8,14,40,3,37,20,63,15,0
Robin Knoche,DF,Union Berlin,de Bundesliga,31,21.3,34,22,27,7,0,19,30,63.3,11,27,19,8,13,47,73,0
Gregor Kobel,GK,Dortmund,de Bundesliga,25,26.3,0,0,0,0,0,0,1,0.0,1,0,0,0,0,0,11,0
Robin Koch,DF,Eint Frankfurt,de Bundesliga,27,30.4,38,23,26,12,0,17,27,63.0,10,33,24,9,32,70,136,2
Philipp Köhn,GK,Monaco,fr Ligue 1,25,22.0,1,1,1,0,0,1,1,100.0,0,0,0,0,1,2,5,3
Dominik Kohr,"DF,MF",Mainz 05,de Bundesliga,29,24.3,65,42,36,25,4,36,57,63.2,21,27,6,21,43,108,58,0
Koke,MF,Atlético Madrid,es La Liga,31,27.7,66,44,27,32,7,36,79,45.6,43,37,12,25,16,82,34,1
Sead Kolašinac,DF,Atalanta,it Serie A,30,24.2,44,32,23,19,2,30,49,61.2,19,22,9,13,21,65,47,0
Luca Koleosho,"MF,FW",Burnley,eng Premier League,18,10.8,7,4,2,5,0,2,10,20.0,8,13,0,13,2,9,0,0
Randal Kolo Muani,"FW,MF",Paris S-G,fr Ligue 1,24,14.1,10,8,5,3,2,5,13,38.5,8,5,0,5,4,14,10,0
Cheick Konaté,DF,Clermont Foot,fr Ligue 1,19,11.9,26,15,17,9,0,20,36,55.6,16,16,2,14,13,39,21,0
Ibrahima Konaté,DF,Liverpool,eng Premier League,24,17.5,36,22,22,13,1,18,24,75.0,6,18,12,6,20,56,51,1
Geoffrey Kondogbia,MF,Marseille,fr Ligue 1,30,16.3,48,31,18,25,5,13,32,40.6,19,21,4,17,30,78,25,0
Amadou Koné,MF,Reims,fr Ligue 1,18,5.3,13,8,11,2,0,6,10,60.0,4,8,3,5,10,23,10,0
Manu Koné,MF,Gladbach,de Bundesliga,22,17.3,45,26,20,20,5,17,25,68.0,8,22,1,21,15,60,16,1
Ezri Konsa,DF,Aston Villa,eng Premier League,25,34.1,54,32,28,23,3,23,27,85.2,4,36,20,16,28,82,73,3
Teun Koopmeiners,MF,Atalanta,it Serie A,25,29.2,39,24,12,22,5,17,50,34.0,33,33,3,30,10,49,35,0
Odilon Kossonou,DF,Leverkusen,de Bundesliga,22,20.1,30,20,11,12,7,15,26,57.7,11,27,3,24,27,57,43,1
Filip Kostić,DF,Juventus,it Serie A,30,20.2,37,23,20,13,4,17,33,51.5,16,29,8,21,9,46,43,0
Christian Kouamé,FW,Fiorentina,it Serie A,25,12.1,13,4,7,6,0,6,10,60.0,4,16,0,16,2,15,10,0
Rominigue Kouamé,MF,Cádiz,es La Liga,26,9.1,14,9,6,7,1,7,15,46.7,8,10,2,8,13,27,10,1
Koffi Kouao,DF,Metz,fr Ligue 1,25,9.6,20,13,12,7,1,11,17,64.7,6,9,6,3,13,33,38,1
Jules Koundé,DF,Barcelona,es La Liga,24,32.2,37,23,22,10,5,28,51,54.9,23,32,12,20,25,62,83,5
Boubakar Kouyaté,DF,Montpellier,fr Ligue 1,26,21.4,49,30,39,8,2,28,51,54.9,23,31,20,11,29,78,123,1
Mateo Kovačić,MF,Manchester City,eng Premier League,29,17.2,36,25,16,15,5,18,28,64.3,10,23,1,22,10,46,10,0
Viktor Kovalenko,MF,Empoli,it Serie A,27,6.8,5,2,2,2,1,2,8,25.0,6,12,2,10,1,6,7,0
Dawid Kownacki,FW,Werder Bremen,de Bundesliga,26,4.2,1,1,1,0,0,1,4,25.0,3,3,1,2,0,1,1,0
Emil Krafth,DF,Newcastle Utd,eng Premier League,28,10.1,21,14,10,7,4,12,25,48.0,13,8,3,5,9,30,21,0
Alex Král,MF,Union Berlin,de Bundesliga,25,15.2,19,14,7,10,2,8,20,40.0,12,15,4,11,11,30,30,0
Andrej Kramarić,"MF,FW",Hoffenheim,de Bundesliga,32,24.4,11,2,5,4,2,6,13,46.2,7,14,2,12,10,21,12,2
Tom Krauß,MF,Mainz 05,de Bundesliga,22,15.0,57,33,22,31,4,21,58,36.2,37,33,4,29,17,74,28,0
Rasmus Kristensen,DF,Roma,it Serie A,26,19.4,36,19,25,8,3,28,50,56.0,22,27,7,20,8,44,50,0
Thomas Kristensen,DF,Udinese,it Serie A,21,23.3,35,24,25,10,0,21,33,63.6,12,29,20,9,29,64,118,0
Toni Kroos,MF,Real Madrid,es La Liga,33,23.6,53,34,19,25,9,24,59,40.7,35,22,4,18,17,70,11,1
Nikola Krstović,FW,Lecce,it Serie A,23,26.4,17,6,3,9,5,6,10,60.0,4,12,4,8,4,21,22,0
Rade Krunić,MF,Milan,it Serie A,29,7.6,10,8,3,6,1,4,9,44.4,5,7,3,4,11,21,14,0
Lukas Kübler,DF,Freiburg,de Bundesliga,30,20.5,50,24,35,13,2,26,42,61.9,16,36,14,22,37,87,57,1
Takefusa Kubo,"FW,MF",Real Sociedad,es La Liga,22,23.9,26,17,15,6,5,9,23,39.1,14,21,2,19,11,37,8,1
Mohammed Kudus,"FW,MF",West Ham,eng Premier League,22,27.6,65,47,27,27,11,20,40,50.0,20,25,0,25,11,76,9,1
Dejan Kulusevski,"FW,MF",Tottenham,eng Premier League,23,30.7,62,33,19,20,23,25,67,37.3,42,24,1,23,18,80,2,1
Sael Kumbedi,DF,Lyon,fr Ligue 1,18,10.3,30,20,14,12,4,9,22,40.9,13,12,3,9,14,44,18,2
Marash Kumbulla,DF,Sassuolo,it Serie A,23,4.0,3,2,2,1,0,1,2,50.0,1,8,6,2,0,3,22,0
Daler Kuzyaev,MF,Le Havre,fr Ligue 1,30,23.2,34,19,11,13,10,15,43,34.9,28,18,5,13,22,56,18,1
Khvicha Kvaratskhelia,FW,Napoli,it Serie A,22,30.4,42,21,11,19,12,15,49,30.6,34,15,1,14,13,55,9,0
Grejohn Kyei,FW,Clermont Foot,fr Ligue 1,27,11.4,6,4,2,2,2,2,3,66.7,1,5,1,4,1,7,10,0
Giorgos Kyriakopoulos,DF,Monza,it Serie A,27,19.0,19,10,16,3,0,11,24,45.8,13,18,1,17,13,32,28,0
Luca de la Torre,MF,Celta Vigo,es La Liga,25,21.7,39,21,12,22,5,22,43,51.2,21,23,4,19,12,51,17,0
Gaëtan Laborde,"FW,MF",Nice,fr Ligue 1,29,21.2,18,12,8,4,6,11,30,36.7,19,20,2,18,6,24,8,1
Alexandre Lacazette,FW,Lyon,fr Ligue 1,32,25.5,19,12,8,9,2,5,17,29.4,12,22,3,19,8,27,9,0
Maxence Lacroix,DF,Wolfsburg,de Bundesliga,23,26.2,48,29,28,18,2,29,41,70.7,12,35,12,23,24,72,121,0
Alban Lafont,GK,Nantes,fr Ligue 1,24,27.7,0,0,0,0,0,0,2,0.0,2,0,0,0,0,0,14,0
Aïssa Laïdouni,MF,Union Berlin,de Bundesliga,26,11.9,21,12,4,12,5,4,12,33.3,8,26,2,24,12,33,14,2
Konrad Laimer,"DF,MF",Bayern Munich,de Bundesliga,26,19.7,56,36,25,20,11,22,52,42.3,30,42,6,36,18,74,13,2
Stefan Lainer,"DF,MF",Gladbach,de Bundesliga,30,8.3,23,16,15,8,0,14,24,58.3,10,13,6,7,5,28,28,0
Kenny Lala,DF,Brest,fr Ligue 1,31,33.0,78,51,39,28,11,30,56,53.6,26,27,6,21,28,106,75,1
Adam Lallana,"MF,FW",Brighton,eng Premier League,35,9.4,8,3,4,4,0,0,4,0.0,4,2,1,1,3,11,1,0
Érik Lamela,"FW,MF",Sevilla,es La Liga,31,5.1,21,14,4,10,7,10,15,66.7,5,12,0,12,1,22,5,0
Mohamed Lamine Bayo,FW,Le Havre,fr Ligue 1,25,15.4,13,5,2,5,6,2,10,20.0,8,8,1,7,2,15,11,0
Didier Lamkel Zé,"FW,MF",Metz,fr Ligue 1,26,6.1,7,2,2,4,1,2,5,40.0,3,4,0,4,0,7,11,0
Tariq Lamptey,"DF,FW",Brighton,eng Premier League,22,10.2,21,14,14,5,2,13,22,59.1,9,7,3,4,6,27,6,0
Bruno Langa,DF,Almería,es La Liga,25,9.1,17,12,10,5,2,6,14,42.9,8,11,4,7,4,21,33,2
Gianluca Lapadula,FW,Cagliari,it Serie A,33,13.4,1,1,0,0,1,1,10,10.0,9,2,1,1,2,3,5,0
Julien Laporte,DF,Lorient,fr Ligue 1,29,20.2,23,14,15,7,1,16,36,44.4,20,36,26,10,11,34,116,1
Cyle Larin,FW,Mallorca,es La Liga,28,20.3,17,8,6,4,7,2,7,28.6,5,16,5,11,3,20,17,0
Yasser Larouci,DF,Sheffield Utd,eng Premier League,22,5.9,17,9,10,5,2,10,14,71.4,4,6,1,5,7,24,20,1
Hugo Larsson,MF,Eint Frankfurt,de Bundesliga,19,21.0,32,18,18,10,4,15,28,53.6,13,34,7,27,29,61,30,1
Jamaal Lascelles,DF,Newcastle Utd,eng Premier League,29,12.0,14,9,7,7,0,6,11,54.5,5,17,12,5,5,19,42,0
Juanmi Latasa,FW,Getafe,es La Liga,22,17.3,9,7,0,6,3,1,11,9.1,10,9,0,9,4,13,21,0
Toni Lato,DF,Mallorca,es La Liga,25,17.2,38,23,19,13,6,16,27,59.3,11,17,3,14,17,55,27,0
Armand Lauriente,FW,Sassuolo,it Serie A,24,32.3,31,20,8,14,9,13,44,29.5,31,29,4,25,15,46,11,0
Valentino Lazaro,"DF,MF",Torino,it Serie A,27,22.2,18,11,7,9,2,13,19,68.4,6,14,1,13,8,26,29,0
Darko Lazović,"FW,MF",Hellas Verona,it Serie A,32,21.4,26,16,11,6,9,16,31,51.6,15,10,1,9,6,32,14,0
Manuel Lazzari,DF,Lazio,it Serie A,29,18.6,26,18,13,10,3,18,28,64.3,10,20,4,16,12,38,37,1
Théo Le Bris,"DF,MF",Lorient,fr Ligue 1,20,16.8,35,22,25,7,3,19,40,47.5,21,24,3,21,12,47,42,0
Julien Le Cardinal,DF,Brest,fr Ligue 1,25,5.3,19,11,11,7,1,8,12,66.7,4,6,3,3,13,32,26,0
Jérémy Le Douaron,FW,Brest,fr Ligue 1,25,18.0,21,10,7,9,5,11,26,42.3,15,14,1,13,2,23,10,0
Enzo Le Fée,MF,Rennes,fr Ligue 1,23,17.0,50,35,23,17,10,23,47,48.9,24,17,3,14,19,69,20,0
Vincent Le Goff,"DF,MF",Lorient,fr Ligue 1,33,6.0,5,0,4,0,1,4,8,50.0,4,11,3,8,3,8,10,0
Robin Le Normand,DF,Real Sociedad,es La Liga,26,27.4,31,22,16,15,0,17,30,56.7,13,26,15,11,28,59,96,1
Rafael Leão,FW,Milan,it Serie A,24,27.9,16,10,3,8,5,8,13,61.5,5,15,1,14,9,25,19,0
Benjamin Lecomte,GK,Montpellier,fr Ligue 1,32,30.0,0,0,0,0,0,0,1,0.0,1,0,0,0,0,0,16,1
Jeremías Ledesma,GK,Cádiz,es La Liga,30,33.9,1,1,1,0,0,1,4,25.0,3,0,0,0,0,1,15,3
Pierre Lees-Melou,MF,Brest,fr Ligue 1,30,28.0,96,67,51,41,4,49,129,38.0,80,61,11,50,43,139,64,3
Diogo Leite,DF,Union Berlin,de Bundesliga,24,30.0,52,36,31,15,6,25,51,49.0,26,48,22,26,47,99,155,1
Maxim Leitsch,DF,Mainz 05,de Bundesliga,25,4.2,6,3,5,1,0,3,6,50.0,3,2,0,2,4,10,13,0
Florian Lejeune,DF,Rayo Vallecano,es La Liga,32,37.0,39,25,26,11,2,19,30,63.3,11,33,18,15,23,62,155,1
Iñigo Lekue,DF,Athletic Club,es La Liga,30,22.2,40,22,25,10,5,27,53,50.9,26,24,6,18,15,55,50,0
Mario Lemina,MF,Wolves,eng Premier League,29,33.0,90,58,46,33,11,25,47,53.2,22,36,9,27,41,131,64,0
Clément Lenglet,DF,Aston Villa,eng Premier League,28,12.8,13,9,7,5,1,7,13,53.8,6,19,11,8,7,20,47,1
Bernd Leno,GK,Fulham,eng Premier League,31,38.0,0,0,0,0,0,0,0,,0,0,0,0,0,0,14,1
Jefferson Lerma,"MF,DF",Crystal Palace,eng Premier League,28,26.7,42,25,15,23,4,19,40,47.5,21,31,12,19,36,78,72,0
Léo Leroy,MF,Montpellier,fr Ligue 1,23,5.5,19,10,8,8,3,6,21,28.6,15,12,3,9,7,26,8,0
Robert Lewandowski,FW,Barcelona,es La Liga,34,30.6,8,5,0,6,2,4,12,33.3,8,13,4,9,9,17,18,0
Jamie Leweling,"FW,MF",Stuttgart,de Bundesliga,22,16.9,18,10,4,6,8,5,17,29.4,12,21,1,20,5,23,13,0
Rico Lewis,"DF,MF",Manchester City,eng Premier League,18,9.0,10,7,4,4,2,3,7,42.9,4,7,1,6,4,14,6,0
Keane Lewis-Potter,"FW,DF",Brentford,eng Premier League,22,16.0,17,7,5,11,1,7,15,46.7,8,10,2,8,7,24,23,0
Philipp Lienhart,DF,Freiburg,de Bundesliga,27,14.1,20,13,14,5,1,13,23,56.5,10,18,11,7,14,34,51,0
Matthijs de Ligt,DF,Bayern Munich,de Bundesliga,23,15.4,15,12,4,8,3,6,11,54.5,5,14,10,4,19,34,52,0
Victor Lindelöf,DF,Manchester Utd,eng Premier League,29,14.8,15,10,8,7,0,5,13,38.5,8,18,9,9,12,27,40,1
Jesper Lindstrøm,"FW,MF",Napoli,it Serie A,23,4.8,8,3,2,3,3,4,8,50.0,4,3,0,3,2,10,6,0
Karol Linetty,MF,Torino,it Serie A,28,20.6,30,21,9,20,1,9,29,31.0,20,24,8,16,23,53,27,1
Samuel Lino,"DF,MF",Atlético Madrid,es La Liga,23,23.1,61,34,32,17,12,35,70,50.0,35,37,1,36,14,75,27,0
Luca Lipani,MF,Sassuolo,it Serie A,18,4.3,9,7,4,3,2,3,11,27.3,8,9,2,7,6,15,7,0
Pol Lirola,DF,Frosinone,it Serie A,25,17.1,30,18,14,15,1,17,35,48.6,18,12,1,11,19,49,41,1
Valentino Livramento,DF,Newcastle Utd,eng Premier League,20,14.6,23,13,15,6,2,10,21,47.6,11,16,7,9,25,48,41,1
Dejan Ljubicic,"MF,FW",Köln,de Bundesliga,25,22.8,43,27,20,18,5,20,43,46.5,23,22,2,20,18,61,11,0
Diego Llorente,DF,Roma,it Serie A,29,24.1,31,19,20,10,1,11,24,45.8,13,40,27,13,22,53,79,0
Marcos Llorente,"MF,DF",Atlético Madrid,es La Liga,28,28.5,40,23,18,17,5,16,44,36.4,28,36,11,25,14,54,35,0
Gautier Lloris,DF,Le Havre,fr Ligue 1,28,30.9,50,28,40,9,1,28,42,66.7,14,50,30,20,32,82,142,1
Giovani Lo Celso,MF,Tottenham,eng Premier League,27,5.6,22,13,10,8,4,9,14,64.3,5,4,1,3,5,27,2,0
Stanislav Lobotka,MF,Napoli,it Serie A,28,36.5,61,39,18,30,13,24,60,40.0,36,30,8,22,30,91,29,0
Manuel Locatelli,MF,Juventus,it Serie A,25,33.4,69,43,24,35,10,31,58,53.4,27,43,17,26,25,94,65,0
Bradley Locko,DF,Brest,fr Ligue 1,21,32.9,97,55,57,34,6,47,80,58.8,33,28,1,27,40,137,69,0
Tom Lockyer,DF,Luton Town,eng Premier League,28,13.0,25,16,17,6,2,15,22,68.2,7,23,13,10,23,48,68,0
Renan Lodi,DF,Marseille,fr Ligue 1,25,13.7,24,16,8,13,3,13,21,61.9,8,7,2,5,16,40,35,0
Ruben Loftus-Cheek,MF,Milan,it Serie A,27,23.0,28,18,7,14,7,15,27,55.6,12,24,12,12,9,37,10,1
Enzo Loiodice,MF,Las Palmas,es La Liga,22,19.9,62,35,15,34,13,20,42,47.6,22,20,2,18,12,74,16,1
Sean Longstaff,MF,Newcastle Utd,eng Premier League,25,30.5,54,30,17,29,8,24,63,38.1,39,43,7,36,17,71,23,0
Ademola Lookman,"FW,MF",Atalanta,it Serie A,25,21.0,20,15,2,11,7,8,22,36.4,14,19,0,19,9,29,0,1
Anthony Lopes,GK,Lyon,fr Ligue 1,32,31.0,0,0,0,0,0,0,0,,0,0,0,0,0,0,16,0
David López,DF,Girona,es La Liga,33,21.8,33,20,21,12,0,17,22,77.3,5,28,19,9,20,53,63,4
Diego López,"MF,FW",Valencia,es La Liga,21,29.5,37,25,14,16,7,13,56,23.2,43,23,1,22,20,57,12,0
Fermin López,"MF,FW",Barcelona,es La Liga,20,16.1,41,21,15,18,8,14,40,35.0,26,14,1,13,4,45,9,0
Javi López,DF,Alavés,es La Liga,21,26.5,23,12,11,9,3,15,26,57.7,11,25,9,16,10,33,77,1
Maxime Lopez,MF,Fiorentina,it Serie A,25,8.9,18,9,5,10,3,6,12,50.0,6,3,1,2,7,25,6,0
Pau López,GK,Marseille,fr Ligue 1,28,32.7,0,0,0,0,0,0,2,0.0,2,0,0,0,0,0,10,1
Unai López,MF,Rayo Vallecano,es La Liga,27,23.4,48,24,18,23,7,21,53,39.6,32,24,3,21,16,64,15,2
Dion Lopy,MF,Almería,es La Liga,21,21.3,62,37,36,20,6,17,44,38.6,27,23,5,18,15,77,22,2
Anthony Losilla,MF,Bochum,de Bundesliga,37,28.6,63,37,15,40,8,23,51,45.1,28,37,8,29,25,88,51,0
Jordan Lotomba,DF,Nice,fr Ligue 1,24,20.0,36,28,18,9,9,25,35,71.4,10,30,9,21,16,52,26,1
Tom Louchet,"MF,DF",Nice,fr Ligue 1,20,4.5,14,5,6,6,2,7,11,63.6,4,7,3,4,3,17,9,0
Imran Louza,MF,Lorient,fr Ligue 1,24,9.6,13,7,2,8,3,2,8,25.0,6,8,1,7,9,22,4,0
Matteo Lovato,DF,Torino,it Serie A,23,6.0,10,7,5,5,0,4,5,80.0,1,9,5,4,13,23,10,0
Matteo Lovato,DF,Salernitana,it Serie A,23,10.5,27,14,17,8,2,16,24,66.7,8,14,7,7,18,45,41,1
Dejan Lovren,DF,Lyon,fr Ligue 1,34,8.0,9,7,6,3,0,3,7,42.9,4,6,5,1,12,21,37,0
Sandi Lovrić,MF,Udinese,it Serie A,25,22.1,25,12,9,11,5,9,23,39.1,14,21,2,19,21,46,24,0
Max Lowe,"DF,MF",Sheffield Utd,eng Premier League,26,5.6,21,10,13,5,3,8,15,53.3,7,10,4,6,5,26,15,0
Anthony Lozano,FW,Almería,es La Liga,30,8.6,7,5,2,5,0,4,7,57.1,3,6,1,5,2,9,12,0
Lucas,DF,Cádiz,es La Liga,22,17.1,47,27,32,11,4,32,55,58.2,23,27,4,23,17,64,45,0
Lorenzo Lucca,FW,Udinese,it Serie A,22,28.8,19,11,4,11,4,5,20,25.0,15,18,3,15,3,22,36,1
Jhon Lucumí,DF,Bologna,it Serie A,25,24.6,48,29,31,17,0,27,36,75.0,9,32,17,15,16,64,68,2
José Luis Gayà,DF,Valencia,es La Liga,28,19.9,71,36,44,23,4,43,67,64.2,24,18,3,15,11,82,42,0
José Luis Morales,"FW,MF",Villarreal,es La Liga,36,11.6,5,3,1,4,0,3,13,23.1,10,9,1,8,7,12,4,0
Douglas Luiz,MF,Aston Villa,eng Premier League,25,33.3,58,38,21,27,10,25,53,47.2,28,32,8,24,23,81,18,2
Romelu Lukaku,FW,Roma,it Serie A,30,29.3,6,5,1,2,3,2,4,50.0,2,7,1,6,0,6,19,1
Castello Lukeba,DF,RB Leipzig,de Bundesliga,20,24.3,19,12,10,9,0,10,12,83.3,2,35,13,22,12,31,94,2
Dodi Lukebakio,"FW,MF",Sevilla,es La Liga,25,12.5,5,2,2,2,1,1,6,16.7,5,9,2,7,2,7,5,0
Saša Lukić,MF,Fulham,eng Premier League,26,12.5,33,19,9,17,7,18,39,46.2,21,18,5,13,16,49,19,1
Andriy Lunin,GK,Real Madrid,es La Liga,24,21.0,0,0,0,0,0,0,1,0.0,1,0,0,0,0,0,15,1
Sebastiano Luperto,DF,Empoli,it Serie A,26,37.8,37,26,25,10,2,15,24,62.5,9,46,35,11,32,69,157,1
Zito Luvumbo,"FW,MF",Cagliari,it Serie A,21,21.6,9,6,5,2,2,4,15,26.7,11,19,0,19,1,10,2,0
Charalambos Lykogiannis,DF,Bologna,it Serie A,29,10.0,10,6,5,4,1,5,10,50.0,5,15,5,10,5,15,30,0
Senne Lynen,MF,Werder Bremen,de Bundesliga,24,20.0,64,38,33,27,4,30,70,42.9,40,41,8,33,41,105,56,0
Ian Maatsen,DF,Dortmund,de Bundesliga,21,14.0,30,22,15,9,6,16,30,53.3,14,22,4,18,13,43,26,0
Alexis Mac Allister,MF,Liverpool,eng Premier League,24,28.9,99,55,35,50,14,59,125,47.2,66,65,8,57,35,134,25,1
Deiver Machado,DF,Lens,fr Ligue 1,29,12.5,24,18,10,10,4,15,20,75.0,5,13,2,11,7,31,8,0
Darwin Machís,MF,Cádiz,es La Liga,30,8.7,23,14,7,9,7,13,24,54.2,11,8,1,7,4,27,2,0
James Maddison,MF,Tottenham,eng Premier League,26,23.7,33,19,5,18,10,15,29,51.7,14,15,3,12,13,46,10,1
Noni Madueke,FW,Chelsea,eng Premier League,21,11.7,16,10,8,4,4,11,34,32.4,23,11,0,11,4,20,14,0
Pablo Maffeo,DF,Mallorca,es La Liga,26,16.2,35,22,18,13,4,23,40,57.5,17,12,2,10,10,45,23,0
Gabriel Magalhães,DF,Arsenal,eng Premier League,25,33.8,48,28,24,22,2,17,22,77.3,5,44,33,11,31,79,100,1
Soungoutou Magassa,"DF,MF",Monaco,fr Ligue 1,19,15.0,56,26,22,32,2,26,48,54.2,22,21,4,17,21,77,36,2
Giulio Maggiore,MF,Salernitana,it Serie A,25,20.0,49,29,26,22,1,20,42,47.6,22,27,5,22,24,73,38,0
Matej Maglica,DF,Darmstadt 98,de Bundesliga,24,18.9,35,21,25,10,0,22,36,61.1,14,29,11,18,22,57,92,5
Giangiacomo Magnani,DF,Hellas Verona,it Serie A,27,27.2,33,18,23,10,0,15,25,60.0,10,50,28,22,45,78,118,0
Hugo Magnetti,MF,Brest,fr Ligue 1,25,26.0,49,27,18,26,5,24,58,41.4,34,19,1,18,18,67,18,0
Yohann Magnin,MF,Clermont Foot,fr Ligue 1,26,18.7,49,31,12,32,5,22,47,46.8,25,38,13,25,19,68,26,1
Frank Magri,"FW,MF",Toulouse,fr Ligue 1,23,16.0,22,14,5,12,5,15,21,71.4,6,16,4,12,4,26,17,0
Harry Maguire,DF,Manchester Utd,eng Premier League,30,18.4,24,17,14,10,0,12,22,54.5,10,33,24,9,25,49,83,1
Arne Maier,MF,Augsburg,de Bundesliga,24,11.1,14,9,5,8,1,5,14,35.7,9,19,2,17,6,20,11,0
Mike Maignan,GK,Milan,it Serie A,28,29.0,1,0,1,0,0,1,1,100.0,0,1,0,1,1,2,4,3
Linton Maina,"FW,MF",Köln,de Bundesliga,24,21.1,18,15,11,5,2,9,28,32.1,19,12,1,11,6,24,12,0
Patrick Mainka,DF,Heidenheim,de Bundesliga,28,34.0,85,49,58,24,3,38,74,51.4,36,66,32,34,49,134,158,1
Kobbie Mainoo,MF,Manchester Utd,eng Premier League,18,21.4,47,27,20,16,11,21,45,46.7,24,20,12,8,22,69,30,1
Ainsley Maitland-Niles,"DF,MF",Lyon,fr Ligue 1,25,15.9,34,18,12,14,8,19,37,51.4,18,16,6,10,17,51,29,1
Radosław Majecki,GK,Monaco,fr Ligue 1,23,12.0,0,0,0,0,0,0,0,,0,1,0,1,0,0,5,1
Lovro Majer,"MF,FW",Wolfsburg,de Bundesliga,25,23.4,39,18,17,22,0,12,31,38.7,19,20,1,19,12,51,13,0
Jean-Victor Makengo,"MF,FW",Lorient,fr Ligue 1,25,5.3,5,4,3,2,0,2,6,33.3,4,12,1,11,8,13,5,0
Jordy Makengo,DF,Freiburg,de Bundesliga,21,11.4,17,11,11,5,1,6,10,60.0,4,16,4,12,11,28,37,0
Antoine Makoumbou,MF,Cagliari,it Serie A,25,30.0,41,24,21,15,5,15,30,50.0,15,23,4,19,16,57,27,2
Nemanja Maksimović,MF,Getafe,es La Liga,28,36.3,65,43,26,31,8,23,41,56.1,18,56,23,33,46,111,61,0
Julián Malatini,DF,Werder Bremen,de Bundesliga,22,6.7,18,13,12,3,3,16,24,66.7,8,8,1,7,13,31,26,0
Youssef Maleh,MF,Empoli,it Serie A,24,28.9,74,48,30,36,8,23,52,44.2,29,62,7,55,25,99,29,0
Donyell Malen,"FW,MF",Dortmund,de Bundesliga,24,19.8,11,7,5,3,3,2,6,33.3,4,11,4,7,2,13,8,0
Ruslan Malinovskyi,MF,Genoa,it Serie A,30,17.2,35,20,18,11,6,17,41,41.5,24,22,8,14,5,40,16,0
Lennard Maloney,MF,Heidenheim,de Bundesliga,23,25.4,43,26,14,24,5,25,59,42.4,34,33,9,24,25,68,88,0
Giorgi Mamardashvili,GK,Valencia,es La Liga,22,36.5,4,3,4,0,0,4,4,100.0,0,1,0,1,2,6,22,2
Gianluca Mancini,DF,Roma,it Serie A,27,31.9,34,20,21,11,2,11,27,40.7,16,38,26,12,36,70,77,1
Steve Mandanda,GK,Rennes,fr Ligue 1,38,34.0,2,0,2,0,0,2,4,50.0,2,0,0,0,0,2,6,1
Christos Mandas,GK,Lazio,it Serie A,21,8.0,0,0,0,0,0,0,1,0.0,1,0,0,0,1,1,3,1
Reinildo Mandava,DF,Atlético Madrid,es La Liga,29,8.1,30,22,16,11,3,19,22,86.4,3,10,2,8,15,45,21,0
Aïssa Mandi,DF,Villarreal,es La Liga,31,12.4,13,8,8,5,0,7,14,50.0,7,10,7,3,8,21,41,0
Rolando Mandragora,MF,Fiorentina,it Serie A,26,17.6,26,11,8,13,5,10,22,45.5,12,14,3,11,9,35,18,1
Orel Mangala,MF,Nott'ham Forest,eng Premier League,25,17.4,27,13,16,10,1,14,29,48.3,15,12,6,6,26,53,32,0
Orel Mangala,MF,Lyon,fr Ligue 1,25,4.4,5,3,0,2,3,1,3,33.3,2,3,2,1,5,10,6,0
Kostas Manolas,DF,Salernitana,it Serie A,32,5.4,9,5,6,3,0,6,8,75.0,2,10,7,3,2,11,20,0
Javier Manquillo,"DF,MF",Celta Vigo,es La Liga,29,8.3,15,11,6,5,4,8,15,53.3,7,14,3,11,3,18,17,0
Solly March,"FW,DF",Brighton,eng Premier League,29,6.2,19,14,9,7,3,8,14,57.1,6,5,0,5,11,30,8,0
Riccardo Marchizza,DF,Frosinone,it Serie A,25,12.8,7,6,4,3,0,3,13,23.1,10,10,2,8,7,14,33,0
Gian Marco Ferrari,DF,Sassuolo,it Serie A,31,25.2,22,10,11,11,0,12,18,66.7,6,28,17,11,25,47,76,0
Óscar de Marcos,DF,Athletic Club,es La Liga,34,25.1,56,39,26,24,6,42,71,59.2,29,28,6,22,15,71,44,0
Pablo Marí,DF,Monza,it Serie A,29,29.1,41,25,34,7,0,22,34,64.7,12,40,25,15,37,78,115,1
José María Giménez,DF,Atlético Madrid,es La Liga,28,14.7,18,10,10,7,1,5,16,31.3,11,16,12,4,10,28,95,0
Rafa Marín,DF,Alavés,es La Liga,21,27.1,32,20,23,9,0,14,27,51.9,13,34,21,13,33,65,129,2
Răzvan Marin,MF,Empoli,it Serie A,27,20.2,40,22,13,23,4,19,29,65.5,10,16,4,12,6,46,30,2
Guillermo Maripán,DF,Monaco,fr Ligue 1,29,19.6,22,8,15,6,1,10,27,37.0,17,26,13,13,30,52,106,4
Mika Màrmol,DF,Las Palmas,es La Liga,21,35.3,70,42,44,24,2,35,53,66.0,18,39,19,20,44,114,147,2
Omar Marmoush,"FW,MF",Eint Frankfurt,de Bundesliga,24,25.6,21,11,7,8,6,6,16,37.5,10,13,0,13,11,32,7,0
Marquinhos,DF,Paris S-G,fr Ligue 1,29,17.1,19,11,10,7,2,11,17,64.7,6,29,19,10,17,36,58,1
Agustín Martegani,MF,Salernitana,it Serie A,23,8.1,13,7,7,3,3,6,18,33.3,12,4,1,3,4,17,7,1
Eric Martel,MF,Köln,de Bundesliga,21,27.3,70,43,32,34,4,37,67,55.2,30,65,19,46,43,113,80,0
Roger Martí,FW,Cádiz,es La Liga,32,15.1,12,6,1,9,2,2,7,28.6,5,16,1,15,7,19,4,0
Anthony Martial,FW,Manchester Utd,eng Premier League,27,5.0,4,1,1,1,2,1,1,100.0,0,4,0,4,0,4,3,0
Aarón Martín,DF,Genoa,it Serie A,26,15.3,21,10,7,10,4,9,22,40.9,13,12,4,8,9,30,15,0
Iván Martín,MF,Girona,es La Liga,24,30.3,44,25,22,15,7,22,57,38.6,35,25,3,22,21,65,14,0
Jonas Martin,MF,Brest,fr Ligue 1,33,13.4,43,27,17,24,2,21,36,58.3,15,16,2,14,9,52,28,2
Gabriel Martinelli,FW,Arsenal,eng Premier League,22,22.4,30,24,9,12,9,13,32,40.6,19,23,1,22,5,35,9,1
Arnau Martinez,DF,Girona,es La Liga,20,13.8,25,16,17,6,2,15,32,46.9,17,15,5,10,10,35,41,3
Emiliano Martínez,GK,Aston Villa,eng Premier League,30,33.5,0,0,0,0,0,0,0,,0,0,0,0,0,0,12,3
Iñigo Martínez,DF,Barcelona,es La Liga,32,14.4,10,7,9,1,0,6,8,75.0,2,13,10,3,11,21,50,0
Josep Martinez,GK,Genoa,it Serie A,25,36.0,0,0,0,0,0,0,0,,0,0,0,0,1,1,21,3
Lautaro Martínez,FW,Inter,it Serie A,25,29.5,22,16,4,13,5,4,19,21.1,15,30,1,29,20,42,10,0
Lisandro Martínez,DF,Manchester Utd,eng Premier League,25,7.2,12,8,8,4,0,5,12,41.7,7,10,8,2,5,17,26,0
Lucas Martínez Quarta,DF,Fiorentina,it Serie A,27,25.5,75,47,43,28,4,36,54,66.7,18,38,14,24,30,105,69,4
Adam Marušić,DF,Lazio,it Serie A,30,34.4,45,31,24,19,2,27,49,55.1,22,27,7,20,29,74,63,2
Marvin,"FW,DF",Las Palmas,es La Liga,23,20.6,39,25,18,17,4,18,36,50.0,18,28,2,26,14,53,18,1
Omar Mascarell,MF,Mallorca,es La Liga,30,17.5,33,16,16,17,0,18,35,51.4,17,24,8,16,31,64,30,1
Adam Masina,DF,Torino,it Serie A,29,11.4,17,12,8,8,1,5,20,25.0,15,12,6,6,11,28,30,0
Erhan Mašović,"DF,MF",Bochum,de Bundesliga,24,24.7,64,40,37,22,5,37,70,52.9,33,32,10,22,25,89,75,2
Clinton Mata,DF,Lyon,fr Ligue 1,30,24.7,43,24,29,8,6,23,40,57.5,17,35,16,19,40,83,61,0
Jaime Mata,"FW,MF",Getafe,es La Liga,34,19.9,24,15,12,8,4,11,26,42.3,15,18,1,17,17,41,31,0
Pape Matar Sarr,MF,Tottenham,eng Premier League,20,23.0,34,24,11,17,6,15,36,41.7,21,21,5,16,31,65,28,1
Jean-Philippe Mateta,FW,Crystal Palace,eng Premier League,26,25.4,22,15,4,11,7,6,10,60.0,4,13,4,9,4,26,14,0
Nemanja Matić,MF,Rennes,fr Ligue 1,34,11.4,19,10,7,9,3,9,12,75.0,3,15,7,8,27,46,19,0
Nemanja Matić,MF,Lyon,fr Ligue 1,34,13.9,17,11,8,7,2,9,19,47.4,10,17,6,11,16,33,17,1
Joël Matip,DF,Liverpool,eng Premier League,31,8.7,12,6,7,4,1,8,12,66.7,4,16,12,4,9,21,43,0
Chrislain Matsima,DF,Clermont Foot,fr Ligue 1,21,13.1,18,11,11,7,0,10,18,55.6,8,14,10,4,13,31,74,1
Azor Matusiwa,MF,Reims,fr Ligue 1,25,15.4,39,27,17,19,3,22,32,68.8,10,21,3,18,33,72,32,1
Azor Matusiwa,MF,Rennes,fr Ligue 1,25,8.8,7,3,3,4,0,4,7,57.1,3,9,2,7,11,18,17,0
Neal Maupay,FW,Brentford,eng Premier League,26,14.7,10,7,4,5,1,3,13,23.1,10,11,0,11,2,12,3,0
Konstantinos Mavropanos,DF,West Ham,eng Premier League,25,16.7,28,16,17,9,2,17,21,81.0,4,21,13,8,23,51,79,3
Christian Mawissa,DF,Toulouse,fr Ligue 1,18,12.4,22,15,14,4,4,9,23,39.1,14,22,11,11,22,44,41,1
Philipp Max,DF,Eint Frankfurt,de Bundesliga,29,15.0,26,17,6,18,2,19,26,73.1,7,18,1,17,7,33,18,2
Eric Maxim Choupo-Moting,"MF,FW",Bayern Munich,de Bundesliga,34,8.0,17,12,8,5,4,6,14,42.9,8,5,0,5,7,24,7,0
Luís Maximiano,GK,Almería,es La Liga,24,33.0,0,0,0,0,0,0,1,0.0,1,0,0,0,0,0,19,2
Borja Mayoral,FW,Getafe,es La Liga,26,23.9,9,5,2,2,5,5,22,22.7,17,7,0,7,4,13,16,0
Noussair Mazraoui,DF,Bayern Munich,de Bundesliga,25,13.3,32,21,14,11,7,13,21,61.9,8,14,1,13,20,52,27,1
Luca Mazzitelli,MF,Frosinone,it Serie A,27,24.6,45,23,15,24,6,26,49,53.1,23,23,7,16,19,64,62,0
Pasquale Mazzocchi,DF,Salernitana,it Serie A,28,14.1,25,19,14,10,1,16,29,55.2,13,14,6,8,5,30,31,0
Pasquale Mazzocchi,DF,Napoli,it Serie A,28,4.8,5,2,1,2,2,2,3,66.7,1,5,1,4,1,6,13,0
Kevin Mbabu,DF,Augsburg,de Bundesliga,28,22.7,51,39,25,18,8,23,40,57.5,17,29,9,20,24,75,48,0
Kylian Mbappé,FW,Paris S-G,fr Ligue 1,24,24.0,4,1,1,1,2,4,9,44.4,5,4,0,4,2,6,2,0
Chancel Mbemba,DF,Marseille,fr Ligue 1,28,24.5,33,21,25,7,1,17,30,56.7,13,21,13,8,13,46,95,1
Bryan Mbeumo,FW,Brentford,eng Premier League,23,21.8,15,10,6,6,3,5,19,26.3,14,26,2,24,7,22,13,0
James Mcatee,"MF,FW",Sheffield Utd,eng Premier League,20,20.2,32,21,9,13,10,13,33,39.4,20,20,0,20,11,43,18,0
Oliver McBurnie,FW,Sheffield Utd,eng Premier League,27,14.2,17,7,4,7,6,5,12,41.7,7,18,2,16,5,22,28,0
John McGinn,"MF,FW",Aston Villa,eng Premier League,28,33.3,59,35,18,34,7,32,77,41.6,45,33,4,29,21,80,21,0
Scott McKenna,DF,Nott'ham Forest,eng Premier League,26,4.6,4,0,3,1,0,2,3,66.7,1,6,4,2,5,9,27,0
Weston McKennie,"MF,DF",Juventus,it Serie A,24,28.8,48,29,31,11,6,17,27,63.0,10,28,7,21,18,66,69,0
Dwight McNeil,"MF,FW",Everton,eng Premier League,23,32.1,44,27,16,14,14,24,55,43.6,31,44,7,37,22,66,37,0
Scott McTominay,"MF,FW",Manchester Utd,eng Premier League,26,21.1,49,25,23,24,2,22,33,66.7,11,34,12,22,14,63,54,0
Facundo Medina,DF,Lens,fr Ligue 1,24,30.2,64,38,25,31,8,44,69,63.8,25,38,13,25,24,88,59,2
Ben Mee,DF,Brentford,eng Premier League,33,14.1,26,15,12,12,2,17,22,77.3,5,21,13,8,13,39,63,1
Marvin Mehlem,MF,Darmstadt 98,de Bundesliga,25,16.5,28,21,10,14,4,11,27,40.7,16,21,2,19,33,61,15,0
Bamo Meïté,DF,Marseille,fr Ligue 1,21,7.1,16,10,13,3,0,8,12,66.7,4,11,5,6,11,27,35,0
Óscar Melendo,"MF,FW",Granada,es La Liga,25,12.5,14,6,4,10,0,4,12,33.3,8,13,0,13,5,19,4,1
Gonzalo Melero,"MF,FW",Almería,es La Liga,29,12.3,14,8,7,5,2,7,19,36.8,12,12,4,8,4,18,11,0
Arthur Melo,MF,Fiorentina,it Serie A,26,22.1,45,30,17,24,4,26,42,61.9,16,27,3,24,18,63,8,0
Memphis,FW,Atlético Madrid,es La Liga,29,9.9,5,2,0,3,2,3,6,50.0,3,2,0,2,1,6,0,0
Houboulang Mendes,DF,Almería,es La Liga,25,4.4,16,13,11,5,0,8,16,50.0,8,4,2,2,1,17,17,1
Brais Méndez,"MF,FW",Real Sociedad,es La Liga,26,26.8,42,28,13,20,9,15,43,34.9,28,23,4,19,12,54,21,0
Bruno Méndez,DF,Granada,es La Liga,23,14.8,36,17,19,12,5,21,37,56.8,16,24,6,18,26,62,45,0
Antoine Mendy,DF,Nice,fr Ligue 1,19,4.6,7,5,4,3,0,3,7,42.9,4,4,1,3,8,15,16,0
Benjamin Mendy,DF,Lorient,fr Ligue 1,29,7.9,3,1,2,1,0,1,5,20.0,4,8,2,6,7,10,20,0
Ferland Mendy,DF,Real Madrid,es La Liga,28,19.1,15,10,12,2,1,11,14,78.6,3,12,2,10,13,28,26,1
Formose Mendy,DF,Lorient,fr Ligue 1,22,14.0,33,19,24,8,1,20,33,60.6,13,23,12,11,20,53,59,1
Nampalys Mendy,MF,Lens,fr Ligue 1,31,11.7,29,18,10,13,6,16,20,80.0,4,11,4,7,14,43,14,1
Teden Mengi,DF,Luton Town,eng Premier League,21,27.4,54,22,33,20,1,19,30,63.3,11,39,27,12,57,111,140,1
Chris Mepham,DF,Bournemouth,eng Premier League,25,6.9,12,11,9,3,0,9,14,64.3,5,13,6,7,7,19,30,1
Jorge Meré,DF,Cádiz,es La Liga,26,7.5,8,7,6,2,0,4,7,57.1,3,5,3,2,8,16,33,0
Alex Meret,GK,Napoli,it Serie A,26,30.8,1,0,1,0,0,1,2,50.0,1,0,0,0,0,1,10,1
Mikel Merino,MF,Real Sociedad,es La Liga,27,27.6,77,43,25,34,18,22,48,45.8,26,36,11,25,16,93,55,3
Quentin Merlin,DF,Marseille,fr Ligue 1,21,7.8,13,12,7,5,1,8,20,40.0,12,4,0,4,6,19,14,0
Quentin Merlin,DF,Nantes,fr Ligue 1,21,14.3,29,20,15,12,2,16,25,64.0,9,22,1,21,18,47,22,0
Junior Messias,"MF,DF",Genoa,it Serie A,32,11.7,26,20,19,5,2,8,19,42.1,11,9,1,8,5,31,22,0
Thomas Meunier,DF,Dortmund,de Bundesliga,31,6.5,5,1,3,2,0,3,13,23.1,10,8,2,6,4,9,22,0
Alexander Meyer,GK,Dortmund,de Bundesliga,32,7.7,1,1,1,0,0,1,1,100.0,0,0,0,0,0,1,2,1
Sven Michel,"FW,MF",Augsburg,de Bundesliga,33,6.5,7,5,2,1,4,2,7,28.6,5,1,0,1,0,7,4,0
Georges Mikautadze,FW,Metz,fr Ligue 1,22,19.4,4,3,1,2,1,0,9,0.0,9,11,0,11,8,12,3,0
Nikola Milenković,DF,Fiorentina,it Serie A,25,27.9,41,21,24,14,3,22,36,61.1,14,22,14,8,27,68,95,1
Lewis Miley,MF,Newcastle Utd,eng Premier League,17,13.4,33,21,6,20,7,15,32,46.9,17,20,3,17,8,41,18,2
Arkadiusz Milik,FW,Juventus,it Serie A,29,10.2,9,5,2,5,2,3,5,60.0,2,7,1,6,5,14,3,0
Vanja Milinković-Savić,GK,Torino,it Serie A,26,36.0,1,0,1,0,0,1,1,100.0,0,0,0,0,1,2,14,4
Éder Militão,DF,Real Madrid,es La Liga,25,5.5,7,3,4,3,0,6,9,66.7,3,4,3,1,4,11,19,1
Luis Milla,MF,Getafe,es La Liga,28,23.5,57,33,19,28,10,28,47,59.6,19,20,1,19,32,89,10,0
Enzo Millot,"MF,FW",Stuttgart,de Bundesliga,21,24.9,40,22,9,21,10,18,39,46.2,21,24,2,22,16,56,7,1
James Milner,"DF,MF",Brighton,eng Premier League,37,8.6,20,14,9,10,1,9,14,64.3,5,9,0,9,8,28,16,0
Kim Min-jae,DF,Bayern Munich,de Bundesliga,26,21.9,37,24,21,11,5,12,24,50.0,12,29,19,10,45,82,70,2
Yerry Mina,DF,Cagliari,it Serie A,28,13.5,20,13,14,6,0,13,19,68.4,6,23,14,9,4,24,77,0
Takumi Minamino,MF,Monaco,fr Ligue 1,28,23.5,34,17,10,13,11,16,54,29.6,38,29,1,28,11,45,8,0
Lucas Mincarelli,"DF,MF",Montpellier,fr Ligue 1,19,10.9,29,16,19,6,4,17,34,50.0,17,17,4,13,8,37,27,0
Óscar Mingueza,"DF,MF",Celta Vigo,es La Liga,24,33.3,62,38,44,11,7,37,80,46.3,43,38,7,31,17,79,49,2
Ignasi Miquel,DF,Granada,es La Liga,30,33.2,47,30,39,6,2,23,40,57.5,17,32,16,16,45,92,132,4
Rafa Mir,"FW,MF",Sevilla,es La Liga,26,4.3,2,2,1,1,0,1,2,50.0,1,2,0,2,1,3,1,0
Aleksei Miranchuk,"MF,FW",Atalanta,it Serie A,27,13.1,12,6,6,4,2,5,13,38.5,8,6,1,5,2,14,5,1
Juan Miranda,DF,Betis,es La Liga,23,20.6,38,24,21,13,4,17,31,54.8,14,31,6,25,19,57,62,0
Fabio Miretti,MF,Juventus,it Serie A,19,12.3,18,14,6,8,4,10,26,38.5,16,10,1,9,7,25,6,0
Tyrick Mitchell,"DF,MF",Crystal Palace,eng Premier League,23,35.6,105,60,75,21,9,43,60,71.7,17,63,10,53,26,131,104,0
Kaoru Mitoma,FW,Brighton,eng Premier League,26,16.5,13,6,3,7,3,5,19,26.3,14,15,1,14,5,18,12,0
Stefan Mitrović,"FW,MF",Hellas Verona,it Serie A,20,4.3,6,3,0,5,1,2,5,40.0,3,6,1,5,0,6,4,0
Stefan Mitrović,DF,Getafe,es La Liga,33,7.8,9,3,7,2,0,4,8,50.0,4,3,2,1,6,15,26,0
Maximilian Mittelstädt,DF,Stuttgart,de Bundesliga,26,23.4,91,51,46,39,6,53,89,59.6,36,36,6,30,46,137,65,0
Henrikh Mkhitaryan,MF,Inter,it Serie A,34,30.9,62,34,18,35,9,24,49,49.0,25,23,4,19,29,91,43,0
Jakub Moder,"MF,DF",Brighton,eng Premier League,24,6.9,19,10,9,5,5,9,18,50.0,9,8,2,6,2,21,12,0
Luka Modrić,MF,Real Madrid,es La Liga,37,18.8,22,15,10,6,6,9,25,36.0,16,13,4,9,21,43,9,0
Terem Moffi,FW,Nice,fr Ligue 1,24,21.7,7,4,0,5,2,3,12,25.0,9,14,1,13,3,10,15,0
Mostafa Mohamed,FW,Nantes,fr Ligue 1,25,22.2,21,14,7,11,3,6,28,21.4,22,21,5,16,12,33,29,0
Dion Moise Sahi,"MF,FW",Strasbourg,fr Ligue 1,21,7.0,5,5,1,2,2,0,3,0.0,3,11,1,10,1,6,7,0
Johan Mojica,DF,Osasuna,es La Liga,30,22.7,30,22,11,15,4,16,25,64.0,9,15,2,13,21,51,40,2
Alberto Moleiro,"FW,MF",Las Palmas,es La Liga,19,20.0,15,6,4,7,4,6,30,20.0,24,11,0,11,7,22,10,0
Nahuel Molina,DF,Atlético Madrid,es La Liga,25,20.6,38,22,16,18,4,26,54,48.1,28,19,3,16,9,47,36,1
Florent Mollet,"MF,FW",Nantes,fr Ligue 1,31,23.1,18,11,8,6,4,10,31,32.3,21,18,5,13,13,31,17,0
Jon Moncayola,MF,Osasuna,es La Liga,25,20.0,27,18,14,10,3,17,42,40.5,25,31,5,26,15,42,21,0
Ilario Monterisi,DF,Frosinone,it Serie A,21,16.3,23,13,14,7,2,12,26,46.2,14,22,18,4,8,31,63,0
César Montes,DF,Almería,es La Liga,26,19.9,22,13,13,9,0,9,18,50.0,9,21,9,12,11,33,94,0
Gonzalo Montiel,DF,Nott'ham Forest,eng Premier League,26,8.9,22,19,12,8,2,16,29,55.2,13,8,3,5,9,31,31,1
Lorenzo Montipò,GK,Hellas Verona,it Serie A,27,37.0,1,1,1,0,0,1,3,33.3,2,0,0,0,0,1,25,2
Álvaro Morata,FW,Atlético Madrid,es La Liga,30,21.2,16,10,4,7,5,3,5,60.0,2,18,3,15,1,17,26,0
Alberto Moreno,DF,Villarreal,es La Liga,31,16.5,31,21,19,10,2,10,30,33.3,20,12,2,10,24,55,33,0
Álex Moreno,DF,Aston Villa,eng Premier League,30,11.5,18,12,18,0,0,12,19,63.2,7,11,2,9,13,31,37,0
Gerard Moreno,FW,Villarreal,es La Liga,31,24.6,25,12,10,7,8,11,25,44.0,14,24,7,17,9,34,24,0
Ilaix Moriba,"MF,FW",Getafe,es La Liga,20,6.7,20,11,3,11,6,4,9,44.4,5,3,1,2,4,24,10,0
Manu Morlanes,MF,Mallorca,es La Liga,24,17.9,50,29,23,26,1,23,53,43.4,30,13,1,12,20,70,21,0
Nikola Moro,MF,Bologna,it Serie A,25,9.3,21,16,8,12,1,8,15,53.3,7,14,1,13,7,28,10,0
Carlton Morris,"FW,MF",Luton Town,eng Premier League,27,31.8,15,8,4,6,5,9,15,60.0,6,24,5,19,1,16,53,0
Cristhian Mosquera,DF,Valencia,es La Liga,19,34.2,57,34,36,18,3,25,39,64.1,14,42,23,19,36,93,137,2
Yerson Mosquera,DF,Villarreal,es La Liga,22,13.7,27,13,18,7,2,12,15,80.0,3,12,2,10,17,44,65,0
Dany Mota,"FW,MF",Monza,it Serie A,25,22.8,13,7,2,5,6,8,17,47.1,9,4,1,3,2,15,18,0
Lebo Mothiba,FW,Strasbourg,fr Ligue 1,27,6.9,5,2,1,4,0,3,4,75.0,1,6,1,5,0,5,11,0
Youssoufa Moukoko,FW,Dortmund,de Bundesliga,18,6.9,4,1,2,2,0,3,7,42.9,4,4,1,3,2,6,4,0
Steve Mounié,FW,Brest,fr Ligue 1,28,19.7,8,7,0,3,5,3,11,27.3,8,13,3,10,2,10,18,0
Mason Mount,"MF,FW",Manchester Utd,eng Premier League,24,5.7,22,14,6,10,6,6,16,37.5,10,6,1,5,6,28,3,0
Samuel Moutoussamy,MF,Nantes,fr Ligue 1,26,12.3,38,20,14,17,7,17,37,45.9,20,16,3,13,11,49,13,0
Mykhailo Mudryk,FW,Chelsea,eng Premier League,22,17.5,21,12,9,7,5,10,32,31.3,22,14,1,13,9,30,9,0
Nordi Mukiele,DF,Paris S-G,fr Ligue 1,25,8.8,12,8,6,5,1,8,15,53.3,7,17,4,13,14,26,28,0
Samuele Mulattieri,"FW,MF",Sassuolo,it Serie A,22,5.1,1,1,0,0,1,1,2,50.0,1,7,2,5,1,2,2,0
Jannik Müller,"DF,MF",Darmstadt 98,de Bundesliga,29,12.6,33,16,21,9,3,16,27,59.3,11,24,12,12,17,50,39,1
Kevin Müller,GK,Heidenheim,de Bundesliga,32,34.0,3,0,3,0,0,3,5,60.0,2,0,0,0,0,3,6,1
Thomas Müller,"MF,FW",Bayern Munich,de Bundesliga,33,18.4,26,16,5,10,11,13,35,37.1,22,22,0,22,3,29,6,0
Abdul Mumin,DF,Rayo Vallecano,es La Liga,25,18.8,19,10,13,4,2,8,10,80.0,2,27,19,8,22,41,82,1
Marshall Munetsi,MF,Reims,fr Ligue 1,27,24.1,61,39,18,34,9,33,61,54.1,28,21,7,14,14,75,33,0
Iker Muniain,"MF,FW",Athletic Club,es La Liga,30,6.6,5,1,2,3,0,1,3,33.3,2,4,1,3,0,5,0,0
Rodrigo Muniz,FW,Fulham,eng Premier League,22,17.7,7,3,1,5,1,1,6,16.7,5,9,3,6,6,13,20,0
Aihen Muñoz,DF,Real Sociedad,es La Liga,25,12.5,36,21,20,10,6,24,35,68.6,11,16,8,8,9,45,33,0
Daniel Muñoz,"DF,MF",Crystal Palace,eng Premier League,27,16.0,55,35,31,14,10,19,38,50.0,19,29,7,22,24,79,47,0
Iker Muñoz,MF,Osasuna,es La Liga,20,20.6,32,18,13,17,2,15,31,48.4,16,16,5,11,11,43,50,0
Javier Muñoz,MF,Las Palmas,es La Liga,28,29.3,42,23,14,22,6,16,44,36.4,28,40,4,36,20,62,29,1
Arijanet Muric,GK,Burnley,eng Premier League,24,10.0,1,1,1,0,0,1,1,100.0,0,0,0,0,0,1,10,4
Luis Muriel,"FW,MF",Atalanta,it Serie A,32,4.5,3,2,0,2,1,1,1,100.0,0,4,0,4,1,4,0,0
Murillo,DF,Nott'ham Forest,eng Premier League,21,31.0,50,31,36,13,1,19,33,57.6,14,41,24,17,37,87,188,0
Vedat Muriqi,FW,Mallorca,es La Liga,29,25.9,11,6,4,3,4,2,14,14.3,12,11,4,7,6,17,26,0
Jacob Murphy,"FW,DF",Newcastle Utd,eng Premier League,28,13.2,20,10,8,4,8,12,26,46.2,14,17,0,17,6,26,16,0
Yunus Musah,"MF,FW",Milan,it Serie A,20,16.4,25,14,15,6,4,8,15,53.3,7,18,4,14,10,35,16,1
Jamal Musiala,"MF,FW",Bayern Munich,de Bundesliga,20,19.5,40,25,9,21,10,14,36,38.9,22,25,1,24,16,56,5,0
Juan Musso,GK,Atalanta,it Serie A,29,11.0,1,0,1,0,0,1,1,100.0,0,0,0,0,0,1,6,0
Yvon Mvogo,GK,Lorient,fr Ligue 1,29,34.0,0,0,0,0,0,0,1,0.0,1,0,0,0,0,0,15,3
Junior Mwanga,"MF,FW",Strasbourg,fr Ligue 1,20,16.1,40,20,23,12,5,12,24,50.0,12,20,5,15,18,58,19,0
Phillipp Mwene,DF,Mainz 05,de Bundesliga,29,22.2,34,15,15,16,3,16,33,48.5,17,27,3,24,17,51,47,0
Vitaliy Mykolenko,DF,Everton,eng Premier League,24,27.4,69,38,46,21,2,41,66,62.1,25,36,11,25,36,105,92,0
Joakim Mæhle,"DF,MF",Wolfsburg,de Bundesliga,26,27.2,62,39,33,18,11,41,64,64.1,23,43,5,38,29,91,65,0
Obite N'Dicka,DF,Roma,it Serie A,23,24.1,32,18,12,19,1,12,20,60.0,8,30,16,14,16,48,75,0
Kévin N'Doram,MF,Metz,fr Ligue 1,27,17.8,31,22,20,9,2,17,38,44.7,21,17,8,9,27,58,38,0
Nathan N'Goumou,"FW,MF",Gladbach,de Bundesliga,23,15.4,37,22,17,18,2,16,34,47.1,18,22,0,22,5,42,17,1
Stanley N'Soki,DF,Hoffenheim,de Bundesliga,24,7.0,21,10,12,8,1,17,29,58.6,12,13,2,11,8,29,33,0
Nacho,DF,Real Madrid,es La Liga,33,19.4,18,10,9,7,2,6,13,46.2,7,23,13,10,18,36,56,0
Marvelous Nakamba,MF,Luton Town,eng Premier League,29,12.6,40,24,24,14,2,24,42,57.1,18,23,6,17,11,51,11,1
Keito Nakamura,"FW,MF",Reims,fr Ligue 1,23,15.3,28,11,9,10,9,17,37,45.9,20,15,2,13,6,34,7,0
Nahitan Nández,"MF,DF",Cagliari,it Serie A,27,26.0,59,40,27,23,9,27,64,42.2,37,25,2,23,19,78,32,0
Matija Nastasić,DF,Mallorca,es La Liga,30,25.1,35,17,26,9,0,24,32,75.0,8,33,20,13,29,64,114,0
Natan,DF,Napoli,it Serie A,22,10.6,14,10,10,3,1,5,10,50.0,5,12,9,3,8,22,32,0
Roberto Navarro,"MF,FW",Cádiz,es La Liga,21,21.0,46,29,20,21,5,22,43,51.2,21,33,0,33,19,65,7,1
Jesús Navas,DF,Sevilla,es La Liga,37,22.3,37,27,21,14,2,22,40,55.0,18,15,7,8,22,59,48,0
Keylor Navas,GK,Paris S-G,fr Ligue 1,36,4.0,0,0,0,0,0,0,0,,0,0,0,0,0,0,2,0
Youssouf Ndayishimiye,"MF,DF",Nice,fr Ligue 1,24,19.0,31,20,17,12,2,12,23,52.2,11,19,11,8,12,43,47,1
Iliman Ndiaye,"FW,MF",Marseille,fr Ligue 1,23,18.0,21,18,5,11,5,11,29,37.9,18,14,2,12,6,27,6,0
Massamba Ndiaye,GK,Clermont Foot,fr Ligue 1,21,4.0,0,0,0,0,0,0,0,,0,0,0,0,0,0,2,0
Rassoul Ndiaye,"MF,FW",Le Havre,fr Ligue 1,21,5.8,25,17,8,16,1,12,24,50.0,12,2,1,1,4,29,5,0
Dan Ndoye,"FW,MF",Bologna,it Serie A,22,19.7,30,15,17,11,2,17,39,43.6,22,20,1,19,10,40,14,0
Joseph Nduquidi,"MF,DF",Metz,fr Ligue 1,18,8.3,11,4,6,3,2,1,9,11.1,8,11,3,8,11,22,15,1
Loïc Nego,"DF,MF",Le Havre,fr Ligue 1,32,17.3,37,26,21,12,4,18,30,60.0,12,12,2,10,16,53,17,0
Neto,GK,Bournemouth,eng Premier League,34,32.0,0,0,0,0,0,0,0,,0,1,0,1,1,1,12,3
Pedro Neto,"FW,MF",Wolves,eng Premier League,23,16.8,7,3,3,2,2,5,15,33.3,10,5,1,4,5,12,2,0
Luca Netz,DF,Gladbach,de Bundesliga,20,24.7,38,22,19,16,3,23,43,53.5,20,36,10,26,22,60,76,1
Manuel Neuer,GK,Bayern Munich,de Bundesliga,37,22.8,1,1,1,0,0,0,0,,0,0,0,0,0,1,14,3
Florian Neuhaus,MF,Gladbach,de Bundesliga,26,13.6,15,12,7,8,0,8,26,30.8,18,8,6,2,14,29,8,0
Carlos Neva,DF,Granada,es La Liga,27,35.0,32,21,22,9,1,17,40,42.5,23,39,14,25,30,62,108,2
Cyril Ngonge,"FW,MF",Hellas Verona,it Serie A,23,15.9,14,9,5,3,6,5,14,35.7,9,7,1,6,4,18,10,0
Moussa Niakhate,DF,Nott'ham Forest,eng Premier League,27,16.2,42,25,33,9,0,20,25,80.0,5,19,12,7,14,56,51,0
M'Baye Niang,FW,Empoli,it Serie A,28,7.9,3,1,0,1,2,0,6,0.0,6,7,1,6,3,6,10,0
Shamar Nicholson,FW,Clermont Foot,fr Ligue 1,26,16.5,6,2,0,4,2,1,4,25.0,3,6,2,4,0,6,15,0
Rasmus Nicolaisen,DF,Toulouse,fr Ligue 1,26,32.5,50,30,39,11,0,26,44,59.1,18,44,33,11,42,92,158,1
Moritz Nicolas,GK,Gladbach,de Bundesliga,25,27.0,1,0,1,0,0,1,3,33.3,2,0,0,0,0,1,12,5
Saúl Ñíguez,MF,Atlético Madrid,es La Liga,28,15.3,64,39,29,29,6,30,49,61.2,19,36,9,27,14,78,56,0
Justin Njinmah,FW,Werder Bremen,de Bundesliga,22,11.3,5,1,2,2,1,3,9,33.3,6,9,1,8,2,7,6,0
Eddie Nketiah,FW,Arsenal,eng Premier League,24,12.0,12,7,2,6,4,2,7,28.6,5,11,0,11,4,16,4,0
Niels Nkounkou,"DF,MF",Eint Frankfurt,de Bundesliga,22,14.5,54,30,34,17,3,29,64,45.3,35,30,2,28,16,70,30,0
Christopher Nkunku,"FW,MF",Chelsea,eng Premier League,25,4.9,5,4,0,4,1,1,2,50.0,1,4,1,3,2,7,4,0
Felix Nmecha,MF,Dortmund,de Bundesliga,22,11.3,19,13,7,8,4,11,22,50.0,11,18,5,13,11,30,19,0
Arnaud Nordin,"FW,MF",Montpellier,fr Ligue 1,25,13.8,12,6,3,5,4,6,16,37.5,10,11,0,11,2,14,10,0
Oliver Norwood,MF,Sheffield Utd,eng Premier League,32,16.0,41,26,18,18,5,20,47,42.6,27,24,9,15,21,62,39,0
Tijjani Noslin,"FW,MF",Hellas Verona,it Serie A,24,14.9,18,8,5,7,6,6,16,37.5,10,17,2,15,2,20,14,0
Randy Nteka,"FW,MF",Rayo Vallecano,es La Liga,25,6.4,11,4,1,6,4,4,10,40.0,6,6,1,5,2,13,11,1
Ernest Nuamah,"FW,MF",Lyon,fr Ligue 1,19,20.4,28,14,18,6,4,12,38,31.6,26,15,1,14,8,36,9,0
Alexander Nübel,GK,Stuttgart,de Bundesliga,26,30.0,2,2,2,0,0,2,4,50.0,2,0,0,0,0,2,13,4
Matheus Nunes,MF,Manchester City,eng Premier League,24,7.3,10,4,1,7,2,5,16,31.3,11,7,1,6,1,11,8,1
Darwin Núñez,FW,Liverpool,eng Premier League,24,22.7,22,12,2,10,10,11,23,47.8,12,18,6,12,3,25,9,0
Unai Núñez,DF,Celta Vigo,es La Liga,26,31.1,51,28,30,19,2,23,49,46.9,26,38,24,14,52,103,153,3
Fabian Nürnberger,"DF,MF",Darmstadt 98,de Bundesliga,24,16.8,29,22,22,6,1,22,41,53.7,19,11,1,10,17,46,26,0
Simeon Nwankwo,FW,Salernitana,it Serie A,31,7.6,6,3,0,2,4,1,3,33.3,2,7,0,7,0,6,4,0
Gerzino Nyamsi,DF,Strasbourg,fr Ligue 1,26,12.1,18,14,13,5,0,12,18,66.7,6,19,11,8,10,28,43,0
Ørjan Nyland,GK,Sevilla,es La Liga,32,24.0,0,0,0,0,0,0,1,0.0,1,0,0,0,0,0,9,1
M'Bala Nzola,FW,Fiorentina,it Serie A,26,17.2,11,8,1,4,6,6,7,85.7,1,10,1,9,0,11,22,0
Christian Nørgaard,MF,Brentford,eng Premier League,29,27.8,81,50,42,31,8,32,87,36.8,55,48,6,42,54,135,50,0
Jake O'Brien,DF,Lyon,fr Ligue 1,22,26.3,22,16,16,5,1,14,20,70.0,6,23,18,5,12,34,98,1
Dara O'Shea,DF,Burnley,eng Premier League,24,32.1,39,20,22,14,3,11,26,42.3,15,41,30,11,35,74,158,2
Adam Obert,DF,Cagliari,it Serie A,20,10.5,17,9,8,8,1,8,17,47.1,9,13,7,6,21,38,41,1
Pedro Obiang,MF,Sassuolo,it Serie A,31,5.0,8,4,3,4,1,2,10,20.0,8,6,4,2,8,16,10,0
Jan Oblak,GK,Atlético Madrid,es La Liga,30,38.0,0,0,0,0,0,0,0,,0,0,0,0,0,0,10,0
Lucas Ocampos,"FW,MF",Sevilla,es La Liga,29,31.9,66,47,22,27,17,29,58,50.0,29,34,1,33,21,87,29,0
Guillermo Ochoa,GK,Salernitana,it Serie A,38,21.0,0,0,0,0,0,0,1,0.0,1,0,0,0,0,0,9,1
Jens Odgaard,"FW,MF",Bologna,it Serie A,24,4.8,4,4,1,1,2,1,3,33.3,2,9,0,9,1,5,3,0
Wilson Odobert,"MF,FW",Burnley,eng Premier League,18,23.3,17,13,8,5,4,6,22,27.3,16,26,2,24,6,23,14,0
Álvaro Odriozola,DF,Real Sociedad,es La Liga,27,4.4,9,7,7,1,1,5,5,100.0,0,2,1,1,8,17,7,0
Tim Oermann,DF,Bochum,de Bundesliga,19,7.9,19,11,11,4,4,9,14,64.3,5,15,6,9,2,21,22,0
Chiedozie Ogbene,"MF,DF",Luton Town,eng Premier League,26,22.2,17,10,10,7,0,12,22,54.5,10,14,3,11,7,24,34,2
Angelo Ogbonna,DF,West Ham,eng Premier League,35,7.1,11,5,9,2,0,6,7,85.7,1,13,10,3,3,14,29,0
Florent Ogier,DF,Clermont Foot,fr Ligue 1,34,10.5,19,9,13,6,0,11,18,61.1,7,25,19,6,9,28,35,3
Noah Okafor,"FW,MF",Milan,it Serie A,23,9.9,6,4,1,4,1,3,10,30.0,7,8,1,7,0,6,10,0
Caleb Okoli,DF,Frosinone,it Serie A,22,32.4,56,34,33,22,1,29,44,65.9,15,48,32,16,29,85,156,4
Maduka Okoye,GK,Udinese,it Serie A,23,21.0,0,0,0,0,0,0,0,,0,0,0,0,1,1,4,2
Joseph Okumu,DF,Reims,fr Ligue 1,26,19.4,44,28,28,14,2,24,38,63.2,14,27,19,8,35,79,112,2
Olasagasti,MF,Real Sociedad,es La Liga,22,4.0,16,13,4,7,5,5,8,62.5,3,2,0,2,3,19,5,1
Finn Ole Becker,MF,Hoffenheim,de Bundesliga,23,6.7,10,9,8,2,0,4,17,23.5,13,9,1,8,1,11,10,0
Michael Olise,"FW,MF",Crystal Palace,eng Premier League,21,14.2,19,10,7,10,2,8,24,33.3,16,21,0,21,11,30,9,0
Mathías Olivera,DF,Napoli,it Serie A,25,17.4,50,29,29,15,6,23,39,59.0,16,35,6,29,20,70,25,0
Dani Olmo,MF,RB Leipzig,de Bundesliga,25,16.1,26,18,14,8,4,10,22,45.5,12,7,0,7,13,39,12,1
Robin Olsen,GK,Aston Villa,eng Premier League,33,4.5,0,0,0,0,0,0,0,,0,0,0,0,0,0,1,0
Warmed Omari,DF,Rennes,fr Ligue 1,23,23.0,32,19,23,7,2,16,28,57.1,12,30,20,10,33,65,77,2
Becir Omeragic,"DF,MF",Montpellier,fr Ligue 1,21,25.7,48,29,31,13,4,20,33,60.6,13,51,29,22,27,75,65,0
Jonas Omlin,GK,Gladbach,de Bundesliga,29,7.0,1,0,1,0,0,1,1,100.0,0,0,0,0,0,1,3,0
Andrew Omobamidele,DF,Nott'ham Forest,eng Premier League,21,8.7,10,3,9,1,0,5,8,62.5,3,12,8,4,13,23,42,1
Samu Omorodion,FW,Alavés,es La Liga,19,21.3,6,3,1,4,1,0,4,0.0,4,11,2,9,1,7,14,0
Amadou Onana,MF,Everton,eng Premier League,21,23.2,71,38,32,31,8,21,42,50.0,21,25,6,19,21,92,31,0
André Onana,GK,Manchester Utd,eng Premier League,27,38.0,2,0,2,0,0,2,2,100.0,0,0,0,0,0,2,11,2
Jean Onana,MF,Marseille,fr Ligue 1,23,6.3,23,14,6,14,3,13,25,52.0,12,10,2,8,11,34,11,1
Karim Onisiwo,"FW,MF",Mainz 05,de Bundesliga,31,16.6,17,8,4,6,7,6,11,54.5,5,18,4,14,2,19,7,0
Fred Onyedinma,"DF,MF",Luton Town,eng Premier League,26,4.5,10,6,7,3,0,5,12,41.7,7,3,0,3,1,11,13,0
Frank Onyeka,MF,Brentford,eng Premier League,25,12.9,37,24,9,23,5,16,29,55.2,13,15,7,8,23,60,17,0
Loïs Openda,FW,RB Leipzig,de Bundesliga,23,30.0,3,3,0,1,2,0,6,0.0,6,19,3,16,5,8,14,0
Christopher Operi,DF,Le Havre,fr Ligue 1,26,27.2,55,36,37,15,3,32,59,54.2,27,45,7,38,35,90,68,1
Gift Orban,FW,Lyon,fr Ligue 1,21,5.3,4,3,0,1,3,1,4,25.0,3,2,0,2,1,5,2,1
Willi Orban,DF,RB Leipzig,de Bundesliga,30,17.6,20,12,8,10,2,9,18,50.0,9,22,13,9,16,36,76,1
Ivan Ordets,DF,Bochum,de Bundesliga,31,20.9,19,14,11,6,2,10,17,58.8,7,41,29,12,31,50,130,0
Divock Origi,FW,Nott'ham Forest,eng Premier League,28,6.7,6,4,5,0,1,0,0,,0,6,0,6,2,8,4,0
Gaetano Oristanio,"FW,MF",Cagliari,it Serie A,20,12.3,20,10,5,14,1,5,17,29.4,12,11,0,11,9,29,8,0
Aimar Oroz,MF,Osasuna,es La Liga,21,26.0,43,26,18,20,5,13,37,35.1,24,27,2,25,16,59,11,0
Riccardo Orsolini,"FW,MF",Bologna,it Serie A,26,19.9,23,14,13,4,6,9,30,30.0,21,25,3,22,8,31,19,1
Stefan Ortega,GK,Manchester City,eng Premier League,30,7.1,0,0,0,0,0,0,0,,0,0,0,0,0,0,2,1
Ben Osborn,"DF,MF",Sheffield Utd,eng Premier League,28,15.2,22,9,11,9,2,8,17,47.1,9,18,2,16,8,30,30,0
Gabriel Osho,DF,Luton Town,eng Premier League,24,20.5,41,22,21,19,1,16,27,59.3,11,37,20,17,31,72,92,0
Victor Osimhen,FW,Napoli,it Serie A,24,22.0,9,5,0,4,5,2,4,50.0,2,5,1,4,2,11,18,0
Patrick Osterhage,MF,Bochum,de Bundesliga,23,20.7,38,26,14,23,1,17,36,47.2,19,36,9,27,27,65,32,1
William Osula,FW,Sheffield Utd,eng Premier League,19,8.7,2,2,1,0,1,1,2,50.0,1,3,1,2,2,4,9,0
Dango Ouattara,"FW,DF",Bournemouth,eng Premier League,21,13.7,45,27,22,11,12,19,34,55.9,15,18,3,15,22,67,35,0
Kassoum Ouattara,"DF,FW",Monaco,fr Ligue 1,18,7.1,17,12,8,5,4,9,20,45.0,11,11,0,11,13,30,20,0
Remi Oudin,"MF,FW",Lecce,it Serie A,26,20.2,26,14,12,12,2,12,19,63.2,7,13,1,12,20,46,22,0
Alexandre Oukidja,GK,Metz,fr Ligue 1,35,33.2,2,1,2,0,0,1,2,50.0,1,1,0,1,3,5,24,3
Azzedine Ounahi,MF,Marseille,fr Ligue 1,23,13.4,25,11,9,14,2,11,32,34.4,21,6,1,5,11,36,8,0
Adam Ounas,FW,Lille,fr Ligue 1,26,4.6,4,3,2,2,0,2,7,28.6,5,2,0,2,6,10,1,0
Aiham Ousou,DF,Cádiz,es La Liga,23,4.8,8,5,6,2,0,5,5,100.0,0,1,0,1,7,15,15,0
Jesús Owono,GK,Alavés,es La Liga,22,4.0,0,0,0,0,0,0,0,,0,0,0,0,0,0,3,0
Mikel Oyarzabal,"FW,MF",Real Sociedad,es La Liga,26,24.0,23,18,7,11,5,7,21,33.3,14,25,4,21,4,27,12,0
Anthony Oyono,DF,Frosinone,it Serie A,22,13.3,37,26,21,14,2,23,34,67.6,11,17,3,14,9,46,32,0
Salih Özcan,MF,Dortmund,de Bundesliga,25,13.2,20,12,11,8,1,10,18,55.6,8,28,3,25,17,37,18,1
Cenk Özkacar,DF,Valencia,es La Liga,22,17.8,26,15,22,4,0,15,23,65.2,8,18,7,11,18,44,84,1
Jon Pacheco,DF,Real Sociedad,es La Liga,22,17.0,25,15,21,4,0,14,22,63.6,8,17,6,11,10,35,53,1
Willian Pacho,DF,Eint Frankfurt,de Bundesliga,21,33.0,62,37,38,23,1,31,53,58.5,22,51,22,29,47,109,152,2
Gonçalo Paciência,"FW,MF",Bochum,de Bundesliga,28,7.2,8,4,2,2,4,3,6,50.0,3,5,0,5,0,8,7,0
Exequiel Palacios,MF,Leverkusen,de Bundesliga,24,20.3,60,34,28,26,6,26,53,49.1,27,24,0,24,29,89,20,2
Isaac Palazón Camacho,"MF,FW",Rayo Vallecano,es La Liga,28,31.0,46,25,16,21,9,20,58,34.5,38,29,2,27,16,62,41,0
João Palhinha,MF,Fulham,eng Premier League,28,30.0,152,75,80,60,12,103,152,67.8,49,57,9,48,46,198,58,0
Nicolas Pallois,DF,Nantes,fr Ligue 1,35,17.7,34,19,21,11,2,19,35,54.3,16,37,26,11,26,60,111,0
Cole Palmer,"FW,MF",Chelsea,eng Premier League,21,29.0,23,12,9,6,8,8,19,42.1,11,20,2,18,20,43,13,2
Emerson Palmieri,DF,West Ham,eng Premier League,28,34.9,106,68,48,42,16,57,90,63.3,33,47,15,32,43,149,96,0
Sokratis Papastathopoulos,DF,Betis,es La Liga,35,12.6,21,14,16,5,0,13,17,76.5,4,15,9,6,6,27,60,0
Leart Paqarada,DF,Köln,de Bundesliga,28,11.9,21,11,9,9,3,11,22,50.0,11,17,5,12,10,31,30,1
Lucas Paquetá,"FW,MF",West Ham,eng Premier League,25,29.1,71,48,38,26,7,25,52,48.1,27,28,1,27,21,92,28,2
Aitor Paredes,DF,Athletic Club,es La Liga,23,30.0,20,11,11,9,0,7,14,50.0,7,23,11,12,33,53,104,0
Kevin Paredes,"FW,MF",Wolfsburg,de Bundesliga,20,15.9,42,21,22,13,7,20,34,58.8,14,27,2,25,23,65,26,0
Leandro Paredes,MF,Roma,it Serie A,29,29.3,57,36,30,22,5,33,77,42.9,44,26,7,19,29,86,43,1
Daniel Parejo,MF,Villarreal,es La Liga,34,28.7,43,30,16,21,6,20,46,43.5,26,25,9,16,21,64,29,3
Fabiano Parisi,DF,Fiorentina,it Serie A,22,16.2,30,15,11,12,7,15,26,57.7,11,21,5,16,17,47,26,0
Thomas Partey,"MF,DF",Arsenal,eng Premier League,30,8.8,14,11,9,4,1,5,10,50.0,5,9,3,6,11,25,9,0
Mario Pašalić,MF,Atalanta,it Serie A,28,22.8,28,17,9,18,1,14,31,45.2,17,29,6,23,16,44,34,0
Triantafyllos Pasaridīs,DF,Salernitana,it Serie A,27,5.0,11,7,9,2,0,9,14,64.3,5,7,3,4,3,14,19,0
Felix Passlack,DF,Bochum,de Bundesliga,25,10.7,21,14,9,10,2,14,24,58.3,10,13,2,11,10,31,21,0
Patric,DF,Lazio,it Serie A,30,17.9,13,8,10,3,0,8,18,44.4,10,15,9,6,6,19,44,0
Rui Patrício,GK,Roma,it Serie A,35,23.0,0,0,0,0,0,0,1,0.0,1,1,0,1,0,0,3,1
Nathan Patterson,DF,Everton,eng Premier League,21,11.2,34,24,21,11,2,14,37,37.8,23,14,3,11,9,43,33,0
Gabriel Paulista,DF,Atlético Madrid,es La Liga,32,4.5,7,5,4,3,0,3,4,75.0,1,5,3,2,4,11,27,0
Gabriel Paulista,DF,Valencia,es La Liga,32,15.5,10,7,8,2,0,6,11,54.5,5,15,7,8,24,34,78,0
Benjamin Pavard,DF,Inter,it Serie A,27,18.6,34,21,21,11,2,20,24,83.3,4,25,15,10,32,66,44,1
Jiří Pavlenka,GK,Werder Bremen,de Bundesliga,31,7.0,0,0,0,0,0,0,0,,0,0,0,0,0,0,2,0
Aleksandar Pavlovic,MF,Bayern Munich,de Bundesliga,19,13.6,28,16,10,14,4,17,33,51.5,16,13,3,10,17,45,12,0
Leonardo Pavoletti,FW,Cagliari,it Serie A,34,7.0,1,1,0,0,1,0,1,0.0,1,2,1,1,0,1,7,0
Martín Payero,MF,Udinese,it Serie A,24,20.0,54,32,28,19,7,19,46,41.3,27,25,7,18,15,69,21,0
Mads Pedersen,DF,Augsburg,de Bundesliga,26,19.8,64,39,31,27,6,24,44,54.5,20,20,3,17,19,83,46,0
Marcus Pedersen,DF,Sassuolo,it Serie A,23,17.9,36,24,25,5,6,21,25,84.0,4,19,5,14,10,46,51,0
Alfonso Pedraza,DF,Villarreal,es La Liga,27,12.4,25,9,18,5,2,9,17,52.9,8,16,7,9,13,38,19,0
Pedri,"MF,FW",Barcelona,es La Liga,20,16.4,33,24,16,13,4,8,27,29.6,19,27,3,24,14,47,10,0
Pedro,"FW,MF",Lazio,it Serie A,36,9.1,16,12,5,7,4,3,12,25.0,9,16,2,14,3,19,1,0
Adrià Pedrosa,DF,Sevilla,es La Liga,25,19.5,46,26,28,14,4,23,34,67.6,11,26,6,20,15,61,54,0
Jordan Pefok,FW,Gladbach,de Bundesliga,27,15.8,10,4,0,8,2,3,8,37.5,5,12,3,9,5,15,28,0
Pietro Pellegri,FW,Torino,it Serie A,22,8.4,5,1,1,4,0,1,5,20.0,4,4,1,3,2,7,3,0
Lorenzo Pellegrini,MF,Roma,it Serie A,27,20.7,35,20,14,16,5,17,51,33.3,34,28,5,23,20,55,22,0
Luca Pellegrini,DF,Lazio,it Serie A,24,8.7,18,13,7,10,1,9,17,52.9,8,7,3,4,9,27,20,0
Marco Pellegrino,DF,Salernitana,it Serie A,,6.1,8,6,4,3,1,5,10,50.0,5,11,6,5,10,18,28,0
Facundo Pellistri,"MF,FW",Granada,es La Liga,21,13.7,29,19,12,10,7,6,21,28.6,15,18,0,18,4,33,7,0
Andy Pelmard,DF,Clermont Foot,fr Ligue 1,23,33.2,51,38,41,9,1,32,40,80.0,8,37,20,17,33,84,99,2
Faris Pemi Moumbagna,FW,Marseille,fr Ligue 1,23,6.1,2,1,0,2,0,0,3,0.0,3,4,0,4,3,5,1,0
Iñaki Peña,GK,Barcelona,es La Liga,24,10.0,0,0,0,0,0,0,1,0.0,1,0,0,0,0,0,5,1
Marcos Peña,MF,Almería,es La Liga,18,4.9,19,14,12,7,0,6,12,50.0,6,9,3,6,13,32,8,0
Rubén Peña,"DF,FW",Osasuna,es La Liga,32,23.2,47,25,22,18,7,20,49,40.8,29,37,8,29,30,77,39,3
Andreas Pereira,MF,Fulham,eng Premier League,27,29.0,25,12,4,12,9,11,41,26.8,30,16,2,14,4,29,12,0
Danilo Pereira,DF,Paris S-G,fr Ligue 1,31,22.2,22,12,14,6,2,9,17,52.9,8,29,26,3,23,45,100,1
Mathias Pereira Lage,"FW,MF",Brest,fr Ligue 1,26,13.2,21,15,7,8,6,7,28,25.0,21,14,5,9,10,31,13,0
Pedro Pereira,DF,Monza,it Serie A,25,9.3,19,13,14,4,1,9,17,52.9,8,15,2,13,4,23,18,0
Roberto Pereyra,"FW,MF",Udinese,it Serie A,32,20.6,19,9,11,5,3,11,29,37.9,18,20,4,16,7,26,18,0
Ayoze Pérez,FW,Betis,es La Liga,30,25.5,59,32,16,33,10,21,49,42.9,28,42,4,38,22,81,18,0
Carles Pérez,"MF,DF",Celta Vigo,es La Liga,25,8.6,13,5,6,5,2,7,18,38.9,11,14,1,13,5,18,8,0
Francisco Perez,"MF,FW",Valencia,es La Liga,20,22.8,30,17,10,14,6,15,44,34.1,29,19,0,19,14,44,5,0
Kike Pérez,"MF,FW",Rayo Vallecano,es La Liga,26,9.3,27,11,11,15,1,11,23,47.8,12,11,0,11,8,35,6,0
Nehuén Pérez,DF,Udinese,it Serie A,23,36.0,72,48,42,28,2,39,48,81.3,9,53,26,27,45,117,158,1
Romain Perraud,"DF,FW",Nice,fr Ligue 1,25,4.1,7,6,5,1,1,4,11,36.4,7,4,0,4,6,13,15,1
Lucas Perrin,DF,Strasbourg,fr Ligue 1,24,30.3,47,30,33,14,0,28,46,60.9,18,45,32,13,28,75,113,0
Máximo Perrone,MF,Las Palmas,es La Liga,20,18.0,42,21,17,22,3,19,39,48.7,20,27,4,23,24,66,21,0
Pavao Pervan,GK,Wolfsburg,de Bundesliga,35,9.0,0,0,0,0,0,0,0,,0,0,0,0,0,0,4,0
Matteo Pessina,MF,Monza,it Serie A,26,35.8,44,25,20,20,4,23,49,46.9,26,29,11,18,27,71,46,1
Andrea Petagna,FW,Cagliari,it Serie A,28,11.1,4,2,1,0,3,1,2,50.0,1,6,3,3,1,5,4,0
Đorđe Petrović,GK,Chelsea,eng Premier League,23,22.1,0,0,0,0,0,0,0,,0,0,0,0,0,0,12,3
Germán Pezzella,DF,Betis,es La Liga,32,30.7,34,24,24,10,0,23,38,60.5,15,31,18,13,31,65,150,0
Giuseppe Pezzella,DF,Empoli,it Serie A,25,12.1,25,14,19,5,1,20,28,71.4,8,17,6,11,2,27,35,0
Luca Pfeiffer,"FW,MF",Darmstadt 98,de Bundesliga,26,18.0,11,6,2,6,3,5,11,45.5,6,5,1,4,2,13,21,0
Patric Pfeiffer,DF,Augsburg,de Bundesliga,23,5.7,11,7,6,4,1,5,6,83.3,1,10,6,4,11,22,21,0
Kamil Piątkowski,DF,Granada,es La Liga,23,5.6,18,10,16,1,1,10,14,71.4,4,6,5,1,8,26,28,1
Roberto Piccoli,FW,Lecce,it Serie A,22,15.3,10,6,3,5,2,1,4,25.0,3,17,1,16,4,14,16,0
Jordan Pickford,GK,Everton,eng Premier League,29,38.0,1,0,1,0,0,1,1,100.0,0,3,0,3,0,1,19,1
Amos Pieper,DF,Werder Bremen,de Bundesliga,25,6.6,14,11,8,6,0,7,13,53.8,6,12,7,5,9,23,36,1
Marvin Pieringer,"MF,FW",Heidenheim,de Bundesliga,23,16.8,19,12,5,11,3,8,20,40.0,12,28,4,24,12,31,21,0
Niccolò Pierozzi,DF,Salernitana,it Serie A,21,9.7,17,11,13,4,0,11,22,50.0,11,24,7,17,11,28,36,0
Ronaël Pierre-Gabriel,DF,Nantes,fr Ligue 1,25,6.6,15,9,12,2,1,5,7,71.4,2,13,4,9,8,23,25,0
Andrea Pinamonti,FW,Sassuolo,it Serie A,24,34.2,13,8,1,6,6,5,22,22.7,17,19,2,17,1,14,40,0
Ethan Pinnock,DF,Brentford,eng Premier League,30,28.0,35,23,22,13,0,9,20,45.0,11,40,24,16,43,78,170,3
Yeremi Pino,"MF,FW",Villarreal,es La Liga,20,5.3,25,18,12,10,3,9,18,50.0,9,11,1,10,5,30,5,0
Lorenzo Pirola,DF,Salernitana,it Serie A,21,22.1,39,23,25,14,0,15,28,53.6,13,46,30,16,25,64,93,1
Alassane Pléa,"FW,MF",Gladbach,de Bundesliga,30,21.3,17,7,5,8,4,7,15,46.7,8,11,0,11,2,19,6,0
Matteo Politano,FW,Napoli,it Serie A,29,26.2,19,8,8,7,4,11,34,32.4,23,9,1,8,15,34,11,1
Sebastian Polter,FW,Darmstadt 98,de Bundesliga,32,5.0,1,0,1,0,0,0,1,0.0,1,5,1,4,0,1,4,0
Julien Ponceau,MF,Lorient,fr Ligue 1,22,24.9,32,15,12,14,6,9,30,30.0,21,22,1,21,19,51,20,0
Marin Pongračić,DF,Lecce,it Serie A,25,35.8,43,30,22,20,1,19,25,76.0,6,37,26,11,51,94,130,1
Nick Pope,GK,Newcastle Utd,eng Premier League,31,14.9,0,0,0,0,0,0,1,0.0,1,0,0,0,0,0,7,2
Pedro Porro,DF,Tottenham,eng Premier League,23,34.3,91,63,43,34,14,62,120,51.7,58,63,18,45,34,125,102,3
Portu,"MF,FW",Girona,es La Liga,31,13.2,18,13,3,10,5,3,18,16.7,15,9,1,8,4,22,6,0
Stefan Posch,DF,Bologna,it Serie A,26,26.8,77,46,35,38,4,49,88,55.7,39,27,8,19,18,95,72,0
Yussuf Poulsen,FW,RB Leipzig,de Bundesliga,29,13.5,13,8,1,9,3,4,14,28.6,10,13,3,10,4,17,15,0
Alejandro Pozo Pozo,"DF,MF",Almería,es La Liga,24,10.8,19,12,11,6,2,12,20,60.0,8,14,4,10,7,26,21,0
Beñat Prados,"MF,DF",Athletic Club,es La Liga,22,16.1,45,28,11,23,11,23,42,54.8,19,32,5,27,23,68,27,0
Matteo Prati,MF,Cagliari,it Serie A,19,21.9,45,25,15,27,3,26,42,61.9,16,29,6,23,15,60,26,1
Abdón Prats,"FW,MF",Mallorca,es La Liga,30,14.1,6,4,2,2,2,3,5,60.0,2,6,3,3,2,8,12,0
Grischa Prömel,MF,Hoffenheim,de Bundesliga,28,23.8,32,18,11,15,6,14,32,43.8,18,22,6,16,22,54,36,0
Ivan Provedel,GK,Lazio,it Serie A,29,30.0,1,0,1,0,0,1,3,33.3,2,0,0,0,0,1,12,1
Marc Pubill,DF,Almería,es La Liga,20,20.9,47,23,35,8,4,22,39,56.4,17,20,8,12,15,62,83,1
Antonio Puertas,"MF,FW",Granada,es La Liga,31,8.1,12,8,6,5,1,6,15,40.0,9,5,0,5,6,18,4,0
Christian Pulisic,"FW,MF",Milan,it Serie A,24,28.9,35,26,14,11,10,17,30,56.7,13,20,1,19,10,45,10,1
Jarell Quansah,DF,Liverpool,eng Premier League,20,13.2,25,22,17,7,1,14,20,70.0,6,16,8,8,17,42,39,1
Adrien Rabiot,MF,Juventus,it Serie A,28,29.5,58,39,22,30,6,30,45,66.7,15,26,6,20,25,83,34,0
Uroš Račić,MF,Sassuolo,it Serie A,25,9.1,10,4,6,4,0,0,9,0.0,9,16,7,9,7,17,22,0
Nemanja Radonjić,"MF,FW",Torino,it Serie A,27,4.2,1,1,0,0,1,1,3,33.3,2,3,0,3,0,1,0,0
Aleksandar Radovanović,DF,Almería,es La Liga,29,6.3,8,7,7,1,0,6,6,100.0,0,8,8,0,11,19,48,0
Boris Radunović,GK,Cagliari,it Serie A,27,7.0,0,0,0,0,0,0,0,,0,0,0,0,1,1,1,2
Hamza Rafia,MF,Lecce,it Serie A,24,13.4,44,31,13,27,4,13,30,43.3,17,27,1,26,11,55,13,0
Antonio Raillo,DF,Mallorca,es La Liga,31,24.4,30,23,18,12,0,17,23,73.9,6,44,30,14,37,67,104,2
Predrag Rajković,GK,Mallorca,es La Liga,27,36.0,2,1,2,0,0,2,2,100.0,0,0,0,0,0,2,14,0
Ivan Rakitić,MF,Sevilla,es La Liga,35,15.8,30,16,9,12,9,11,19,57.9,8,16,5,11,14,44,12,0
Ylber Ramadani,MF,Lecce,it Serie A,27,33.0,68,41,32,29,7,37,96,38.5,59,54,13,41,44,112,44,0
Largie Ramazani,"FW,MF",Almería,es La Liga,22,17.3,12,7,5,6,1,6,26,23.1,20,16,2,14,34,46,10,0
Benito Ramírez,"FW,MF",Las Palmas,es La Liga,28,4.3,5,3,2,3,0,3,6,50.0,3,7,1,6,3,8,0,0
Sandro Ramírez,FW,Las Palmas,es La Liga,28,20.1,12,8,4,6,2,6,15,40.0,9,13,1,12,4,16,14,1
Chris Ramos,"FW,MF",Cádiz,es La Liga,26,29.0,28,15,9,15,4,8,27,29.6,19,23,7,16,9,37,44,0
Gonçalo Ramos,FW,Paris S-G,fr Ligue 1,22,15.8,25,15,4,12,9,6,20,30.0,14,12,2,10,5,30,16,0
Sergio Ramos,DF,Sevilla,es La Liga,37,28.0,45,30,32,11,2,27,40,67.5,13,35,30,5,41,86,156,0
Aaron Ramsdale,GK,Arsenal,eng Premier League,25,6.0,0,0,0,0,0,0,0,,0,0,0,0,0,0,3,2
Aaron Ramsey,"MF,FW",Burnley,eng Premier League,20,5.9,17,14,7,5,5,8,16,50.0,8,11,2,9,1,18,10,0
Jacob Ramsey,"FW,MF",Aston Villa,eng Premier League,22,9.5,16,8,7,6,3,5,15,33.3,10,15,2,13,3,19,8,0
Luca Ranieri,DF,Fiorentina,it Serie A,24,22.9,14,10,11,1,2,8,13,61.5,5,25,11,14,29,43,64,0
Filippo Ranocchia,"MF,DF",Empoli,it Serie A,22,5.3,16,11,7,9,0,7,16,43.8,9,9,1,8,3,19,14,0
Raphinha,"FW,MF",Barcelona,es La Liga,26,15.2,14,8,6,6,2,4,18,22.2,14,17,1,16,13,27,11,0
Elba Rashani,"MF,FW",Clermont Foot,fr Ligue 1,30,13.1,30,18,4,17,9,11,24,45.8,13,17,3,14,12,42,15,0
Marcus Rashford,FW,Manchester Utd,eng Premier League,25,25.2,19,12,9,4,6,9,26,34.6,17,15,1,14,4,23,21,0
Giacomo Raspadori,"FW,MF",Napoli,it Serie A,23,17.6,21,10,6,10,5,6,15,40.0,9,15,1,14,3,24,7,0
Andrei Ratiu,"DF,MF",Rayo Vallecano,es La Liga,25,7.0,12,4,6,5,1,8,15,53.3,7,4,1,3,0,12,12,0
Raúl,FW,Osasuna,es La Liga,22,15.1,10,4,4,2,4,2,10,20.0,8,9,1,8,5,15,11,0
David Raum,DF,RB Leipzig,de Bundesliga,25,30.4,58,35,24,29,5,34,58,58.6,24,51,9,42,27,85,82,2
Federico Ravaglia,GK,Bologna,it Serie A,23,5.9,0,0,0,0,0,0,0,,0,0,0,0,0,0,2,0
David Raya,GK,Arsenal,eng Premier League,27,32.0,1,1,1,0,0,1,1,100.0,0,0,0,0,0,1,8,5
Tim Ream,DF,Fulham,eng Premier League,35,16.7,20,9,13,5,2,9,18,50.0,9,23,15,8,25,45,61,2
Abderrahman Rebbach,"FW,MF",Alavés,es La Liga,24,8.0,9,5,4,2,3,5,15,33.3,10,10,1,9,3,12,7,0
Harrison Reed,MF,Fulham,eng Premier League,28,14.7,29,18,9,17,3,13,31,41.9,18,19,9,10,11,40,24,0
Sergio Reguilón,DF,Manchester Utd,eng Premier League,26,4.6,13,8,6,2,5,8,17,47.1,9,10,0,10,5,18,7,0
Sergio Reguilón,DF,Brentford,eng Premier League,26,12.4,45,20,26,18,1,24,40,60.0,16,23,6,17,16,61,41,1
Bobby Reid,FW,Fulham,eng Premier League,30,15.8,22,14,5,15,2,4,16,25.0,12,24,2,22,5,27,14,0
Tijjani Reijnders,MF,Milan,it Serie A,25,31.3,46,25,10,31,5,21,43,48.8,22,26,8,18,18,64,26,0
Reinier,"MF,FW",Frosinone,it Serie A,21,11.8,21,10,6,12,3,5,17,29.4,12,24,4,20,10,31,5,0
Rocco Reitz,MF,Gladbach,de Bundesliga,21,23.7,61,36,28,29,4,28,55,50.9,27,61,20,41,44,105,31,1
Álex Remiro,GK,Real Sociedad,es La Liga,28,36.4,0,0,0,0,0,0,0,,0,0,0,0,0,0,24,2
Guillaume Restes,GK,Toulouse,fr Ligue 1,18,34.0,0,0,0,0,0,0,3,0.0,3,0,0,0,0,0,19,1
Mateo Retegui,FW,Genoa,it Serie A,24,24.6,17,9,7,8,2,6,20,30.0,14,18,2,16,0,17,30,0
Marco Reus,"MF,FW",Dortmund,de Bundesliga,34,17.8,37,25,20,14,3,12,27,44.4,15,17,2,15,5,42,18,0
Elvis Rexhbeçaj,MF,Augsburg,de Bundesliga,25,22.1,30,19,14,13,3,18,36,50.0,18,32,7,25,20,50,20,0
Chadi Riad,DF,Betis,es La Liga,20,24.0,35,24,17,18,0,17,27,63.0,10,23,14,9,23,58,108,0
Alexsandro Ribeiro,DF,Lille,fr Ligue 1,23,24.7,32,22,24,8,0,16,31,51.6,15,25,15,10,35,67,116,5
Samuele Ricci,MF,Torino,it Serie A,21,26.6,33,18,17,12,4,15,23,65.2,8,21,3,18,27,60,25,0
Declan Rice,MF,Arsenal,eng Premier League,24,35.8,83,51,37,38,8,32,57,56.1,25,37,11,26,44,127,52,0
Chris Richards,"DF,MF",Crystal Palace,eng Premier League,23,23.3,46,28,21,22,3,20,30,66.7,10,32,12,20,27,73,109,0
Amir Richardson,MF,Reims,fr Ligue 1,21,15.0,33,23,12,18,3,10,22,45.5,12,26,5,21,15,48,30,0
Richarlison,FW,Tottenham,eng Premier League,26,16.6,16,11,4,8,4,2,10,20.0,8,32,6,26,8,24,23,0
Marco Richter,"MF,FW",Mainz 05,de Bundesliga,25,8.0,10,4,5,3,2,4,11,36.4,7,9,0,9,2,12,1,0
Diego Rico,DF,Getafe,es La Liga,30,28.2,64,48,32,23,9,41,76,53.9,35,25,8,17,41,105,76,0
Clemens Riedel,DF,Darmstadt 98,de Bundesliga,20,8.4,22,13,16,5,1,15,24,62.5,9,11,3,8,11,33,26,0
Fabian Rieder,MF,Rennes,fr Ligue 1,21,4.1,13,7,2,9,2,6,11,54.5,5,3,1,2,5,18,2,0
Manuel Riemann,GK,Bochum,de Bundesliga,34,33.0,2,1,2,0,0,2,4,50.0,2,0,0,0,1,3,25,1
Luis Rioja,"FW,MF",Alavés,es La Liga,29,27.8,27,19,10,12,5,14,43,32.6,29,28,1,27,16,43,28,0
Rodrigo Riquelme,"DF,MF",Atlético Madrid,es La Liga,23,17.0,30,19,18,4,8,18,46,39.1,28,19,0,19,9,39,20,0
Mihailo Ristić,"DF,MF",Celta Vigo,es La Liga,27,9.0,15,9,9,6,0,9,12,75.0,3,9,2,7,10,25,23,0
Sergi Roberto,"MF,DF",Barcelona,es La Liga,31,9.6,15,10,4,10,1,3,11,27.3,8,7,2,5,8,23,7,1
Lucas Robertone,MF,Almería,es La Liga,26,26.5,61,33,28,23,10,25,50,50.0,25,43,9,34,51,112,43,0
Connor Roberts,DF,Burnley,eng Premier League,27,9.1,12,5,6,4,2,8,17,47.1,9,8,6,2,4,16,25,2
Andrew Robertson,DF,Liverpool,eng Premier League,29,18.8,35,24,21,11,3,26,43,60.5,17,20,6,14,13,48,40,0
Antonee Robinson,DF,Fulham,eng Premier League,25,36.3,93,58,60,26,7,52,110,47.3,58,56,8,48,80,173,117,3
Jack Robinson,DF,Sheffield Utd,eng Premier League,29,32.1,43,28,29,14,0,25,39,64.1,14,49,33,16,33,76,132,2
Marc Roca,MF,Betis,es La Liga,26,22.0,52,36,17,29,6,30,53,56.6,23,29,6,23,17,69,23,1
Rodri,MF,Manchester City,eng Premier League,27,32.6,70,43,25,33,12,29,60,48.3,31,32,8,24,26,96,41,4
Rodri,"FW,MF",Betis,es La Liga,23,11.7,17,10,6,7,4,8,21,38.1,13,11,0,11,8,25,2,0
Óscar Rodríguez Arnaiz,"MF,FW",Getafe,es La Liga,25,10.7,24,13,2,15,7,9,15,60.0,6,12,1,11,5,29,5,0
Dani Rodríguez,MF,Mallorca,es La Liga,35,29.1,47,24,21,20,6,21,45,46.7,24,34,5,29,15,62,21,0
Guido Rodríguez,MF,Betis,es La Liga,29,20.5,53,30,21,24,8,34,55,61.8,21,27,6,21,29,82,44,0
Jay Rodriguez,FW,Burnley,eng Premier League,34,9.1,14,9,7,4,3,7,13,53.8,6,11,1,10,1,15,8,0
Kirian Rodríguez,MF,Las Palmas,es La Liga,27,35.7,52,32,22,25,5,24,67,35.8,43,39,3,36,28,80,23,1
Ricardo Rodríguez,DF,Torino,it Serie A,30,30.8,45,26,21,22,2,28,45,62.2,17,22,9,13,24,69,64,2
Rodrygo,FW,Real Madrid,es La Liga,22,26.4,16,15,2,9,5,5,19,26.3,14,14,0,14,8,24,6,0
Mads Roerslev,DF,Brentford,eng Premier League,24,22.1,48,31,34,9,5,27,54,50.0,27,15,3,12,19,67,71,0
Rogério,DF,Wolfsburg,de Bundesliga,25,10.1,14,6,7,5,2,10,14,71.4,4,16,5,11,5,19,23,1
Morgan Rogers,"MF,FW",Aston Villa,eng Premier League,21,7.1,8,1,3,2,3,2,11,18.2,9,11,0,11,3,11,11,0
Merlin Röhl,"MF,FW",Freiburg,de Bundesliga,21,16.4,21,13,10,9,2,8,21,38.1,13,27,3,24,9,30,22,0
Alessio Romagnoli,DF,Lazio,it Serie A,28,26.8,25,18,14,11,0,16,24,66.7,8,29,17,12,29,54,115,0
Simone Romagnoli,DF,Frosinone,it Serie A,33,30.2,35,15,23,11,1,15,20,75.0,5,51,36,15,29,64,147,0
Cristian Romero,DF,Tottenham,eng Premier League,25,31.0,66,40,35,25,6,32,44,72.7,12,46,22,24,44,110,106,1
Luka Romero,FW,Almería,es La Liga,18,4.9,5,1,2,3,0,2,4,50.0,2,12,1,11,1,6,2,1
Oriol Romeu,MF,Barcelona,es La Liga,31,10.4,34,20,17,14,3,13,24,54.2,11,12,2,10,10,44,18,0
Valentin Rongier,MF,Marseille,fr Ligue 1,28,9.5,23,12,9,12,2,14,26,53.8,12,16,4,12,15,38,18,0
Marten de Roon,"MF,DF",Atalanta,it Serie A,32,28.9,80,43,36,32,12,35,82,42.7,47,36,10,26,40,120,54,0
Pablo Rosario,"MF,DF",Nice,fr Ligue 1,26,22.3,36,25,15,16,5,23,34,67.6,11,27,13,14,29,65,39,0
Joe Rothwell,MF,Bournemouth,eng Premier League,28,4.3,7,2,4,2,1,2,8,25.0,6,4,2,2,3,10,2,0
Anthony Rouault,DF,Stuttgart,de Bundesliga,22,11.2,21,12,14,5,2,13,21,61.9,8,14,8,6,8,29,28,0
Jérôme Roussillon,DF,Union Berlin,de Bundesliga,30,8.4,16,9,6,7,3,8,12,66.7,4,13,4,9,5,21,26,0
Nicolò Rovella,MF,Lazio,it Serie A,21,14.6,46,28,25,17,4,16,36,44.4,20,27,6,21,23,69,29,0
Amir Rrahmani,DF,Napoli,it Serie A,29,28.9,33,27,17,14,2,16,32,50.0,16,24,10,14,20,53,90,0
Ruan,DF,Sassuolo,it Serie A,24,16.8,25,15,11,10,4,10,18,55.6,8,18,15,3,24,49,68,2
Pelly Ruddock Mpanzu,MF,Luton Town,eng Premier League,30,12.2,13,5,6,6,1,5,9,55.6,4,15,7,8,9,22,16,3
Antonio Rüdiger,DF,Real Madrid,es La Liga,30,30.1,26,15,18,4,4,16,20,80.0,4,27,20,7,11,37,89,0
Daniele Rugani,DF,Juventus,it Serie A,29,13.2,11,9,7,3,1,4,5,80.0,1,11,4,7,9,20,42,0
Matteo Ruggeri,DF,Atalanta,it Serie A,21,27.2,29,15,14,7,8,16,30,53.3,14,46,4,42,23,52,44,0
Mário Rui,DF,Napoli,it Serie A,32,13.4,27,15,17,5,5,14,21,66.7,7,17,2,15,15,42,19,0
Aitor Ruibal,"DF,FW",Betis,es La Liga,27,11.3,46,27,28,13,5,32,59,54.2,27,12,1,11,14,60,33,1
Fabián Ruiz Peña,MF,Paris S-G,fr Ligue 1,27,13.3,34,23,17,14,3,23,42,54.8,19,8,2,6,11,45,21,2
Sergio Ruiz,MF,Granada,es La Liga,28,27.7,83,46,43,36,4,38,84,45.2,46,24,6,18,28,111,43,1
Julian Ryerson,DF,Dortmund,de Bundesliga,25,19.6,41,23,26,11,4,27,47,57.4,20,31,7,24,10,51,35,3
Frederik Rønnow,GK,Union Berlin,de Bundesliga,30,33.0,1,1,1,0,0,0,0,,0,0,0,0,1,2,20,2
José Sá,GK,Wolves,eng Premier League,30,33.7,0,0,0,0,0,0,1,0.0,1,3,0,3,0,0,21,5
Youssouf Sabaly,DF,Betis,es La Liga,30,11.6,16,11,12,3,1,8,12,66.7,4,6,3,3,11,27,27,0
Emmanuel Sabbi,"FW,MF",Le Havre,fr Ligue 1,25,17.6,38,19,15,15,8,16,39,41.0,23,26,2,24,19,57,7,0
Stefano Sabelli,DF,Genoa,it Serie A,30,27.0,50,24,28,19,3,15,46,32.6,31,27,6,21,23,73,35,0
Marcel Sabitzer,MF,Dortmund,de Bundesliga,29,21.8,39,24,18,20,1,23,42,54.8,19,31,12,19,12,51,34,0
Falaye Sacko,DF,Montpellier,fr Ligue 1,28,15.4,28,16,13,10,5,21,32,65.6,11,19,7,12,24,52,37,0
Umar Sadiq,FW,Real Sociedad,es La Liga,26,12.0,15,10,2,8,5,4,8,50.0,4,9,0,9,0,15,10,0
Alexis Saelemaekers,"FW,MF",Bologna,it Serie A,24,21.0,32,22,13,14,5,12,27,44.4,15,13,1,12,13,45,10,1
Modibo Sagnan,DF,Montpellier,fr Ligue 1,24,11.7,34,22,23,9,2,15,25,60.0,10,13,9,4,15,49,67,0
Wesley Saïd,"FW,MF",Lens,fr Ligue 1,28,11.3,8,4,1,2,5,2,9,22.2,7,4,0,4,4,12,3,0
Bukayo Saka,FW,Arsenal,eng Premier League,21,32.4,66,35,22,24,20,26,59,44.1,33,43,2,41,15,81,24,1
Ibrahim Salah,"FW,MF",Rennes,fr Ligue 1,21,5.8,15,7,5,6,4,11,18,61.1,7,4,0,4,10,25,5,0
Mohamed Salah,FW,Liverpool,eng Premier League,31,28.2,17,11,1,8,8,6,21,28.6,15,19,1,18,2,19,1,0
Kike Salas,DF,Sevilla,es La Liga,21,17.8,41,23,26,12,3,22,36,61.1,14,25,14,11,26,67,91,1
William Saliba,DF,Arsenal,eng Premier League,22,38.0,41,26,28,12,1,20,27,74.1,7,32,17,15,29,70,81,3
Mohammed Salisu,DF,Monaco,fr Ligue 1,24,11.5,27,12,11,13,3,17,26,65.4,9,21,12,9,22,49,44,0
Roland Sallai,"MF,FW",Freiburg,de Bundesliga,26,20.4,17,10,5,5,7,8,20,40.0,12,21,1,20,6,23,23,0
Yoann Salmier,DF,Le Havre,fr Ligue 1,30,17.4,22,10,13,6,3,13,20,65.0,7,21,15,6,21,43,57,0
Lazar Samardzic,MF,Udinese,it Serie A,21,26.4,40,19,18,18,4,16,39,41.0,23,26,6,20,10,50,25,0
Mama Samba Baldé,"FW,MF",Lyon,fr Ligue 1,27,6.1,8,5,1,2,5,3,9,33.3,6,0,0,0,3,11,1,1
Brice Samba,GK,Lens,fr Ligue 1,29,33.0,1,1,1,0,0,1,1,100.0,0,0,0,0,0,1,10,3
Albert Sambi Lokonga,MF,Luton Town,eng Premier League,23,14.5,29,18,14,12,3,17,24,70.8,7,23,13,10,11,40,14,0
Junior Sambia,"DF,MF",Salernitana,it Serie A,26,11.5,12,5,8,1,3,6,11,54.5,5,15,7,8,11,23,28,0
Antonio Sanabria,"FW,MF",Torino,it Serie A,27,23.7,18,15,5,9,4,4,9,44.4,5,7,1,6,6,24,12,0
Oihan Sancet,MF,Athletic Club,es La Liga,23,21.9,19,11,3,10,6,8,21,38.1,13,5,1,4,10,29,5,0
Ricard Sánchez,DF,Granada,es La Liga,23,25.5,29,18,15,8,6,12,24,50.0,12,32,4,28,13,42,64,0
Alexis Sánchez,"FW,MF",Inter,it Serie A,34,8.5,7,6,0,5,2,1,4,25.0,3,4,1,3,1,8,3,0
Antonio Sánchez,MF,Mallorca,es La Liga,26,16.1,25,11,13,10,2,11,32,34.4,21,24,5,19,13,38,13,0
Juanlu Sánchez,DF,Sevilla,es La Liga,19,13.1,56,35,34,18,4,34,58,58.6,24,24,7,17,12,68,36,0
Manu Sánchez,"DF,MF",Celta Vigo,es La Liga,22,19.7,54,28,21,25,8,31,55,56.4,24,23,3,20,19,73,65,0
Robert Sánchez,GK,Chelsea,eng Premier League,25,15.9,0,0,0,0,0,0,0,,0,0,0,0,0,0,11,3
Jadon Sancho,"FW,MF",Dortmund,de Bundesliga,23,10.5,5,4,1,3,1,0,4,0.0,4,11,0,11,4,9,6,0
Alex Sandro,DF,Juventus,it Serie A,32,8.0,13,7,7,6,0,4,5,80.0,1,13,7,6,15,28,23,0
Leroy Sané,FW,Bayern Munich,de Bundesliga,27,23.7,15,8,6,6,3,4,19,21.1,15,12,0,12,7,22,3,0
Sadibou Sané,DF,Metz,fr Ligue 1,19,9.4,19,12,16,2,1,6,7,85.7,1,14,9,5,8,27,64,0
Arouna Sangante,DF,Le Havre,fr Ligue 1,21,29.9,53,33,27,23,3,24,40,60.0,16,35,18,17,66,119,93,2
Ibrahim Sangaré,MF,Nott'ham Forest,eng Premier League,25,11.5,42,23,25,13,4,12,29,41.4,17,24,7,17,16,58,21,0
Morgan Sanson,MF,Nice,fr Ligue 1,28,21.8,26,19,12,7,7,12,31,38.7,19,34,5,29,20,46,16,0
Nicola Sansone,"FW,MF",Lecce,it Serie A,31,8.5,11,6,6,2,3,5,16,31.3,11,7,1,6,4,15,5,2
Baptiste Santamaria,MF,Rennes,fr Ligue 1,28,21.4,52,33,21,25,6,29,46,63.0,17,15,6,9,34,86,33,1
Jesús Santiago,MF,Getafe,es La Liga,19,7.3,17,8,8,5,4,4,7,57.1,3,3,0,3,0,17,8,0
Andrey Santos,MF,Strasbourg,fr Ligue 1,19,9.2,29,18,15,13,1,17,26,65.4,9,8,0,8,10,39,11,1
Tiago Santos,DF,Lille,fr Ligue 1,21,26.3,63,42,31,19,13,30,52,57.7,22,24,5,19,15,78,37,0
Pablo Sarabia,"MF,FW",Wolves,eng Premier League,31,19.4,20,13,8,8,4,12,36,33.3,24,17,1,16,10,30,9,0
Amin Sarr,"FW,MF",Wolfsburg,de Bundesliga,22,4.3,3,2,1,2,0,1,2,50.0,1,6,1,5,2,5,1,0
Ismaila Sarr,"FW,MF",Marseille,fr Ligue 1,25,16.1,14,8,2,10,2,6,17,35.3,11,21,6,15,13,27,11,0
Martin Satriano,FW,Brest,fr Ligue 1,22,20.7,24,16,6,13,5,10,25,40.0,15,19,7,12,7,31,28,0
Téji Savanier,MF,Montpellier,fr Ligue 1,31,30.7,37,20,16,15,6,14,63,22.2,49,36,8,28,33,70,28,1
Stefan Savić,DF,Atlético Madrid,es La Liga,32,18.1,27,19,16,7,4,15,30,50.0,15,29,15,14,27,54,61,1
Sávio,"FW,MF",Girona,es La Liga,19,33.1,42,25,14,22,6,16,28,57.1,12,34,0,34,18,60,11,1
Saba Sazonov,DF,Torino,it Serie A,21,4.0,9,7,4,5,0,3,3,100.0,0,8,5,3,3,12,22,0
Joe Scally,DF,Gladbach,de Bundesliga,20,24.8,41,28,21,17,3,23,40,57.5,17,31,11,20,18,59,78,2
Giorgio Scalvini,DF,Atalanta,it Serie A,19,28.3,53,33,29,19,5,19,40,47.5,21,44,17,27,59,112,71,0
Gianluca Scamacca,FW,Atalanta,it Serie A,24,16.1,15,9,4,5,6,7,14,50.0,7,7,1,6,4,19,9,0
András Schäfer,MF,Union Berlin,de Bundesliga,24,13.5,29,16,9,15,5,11,20,55.0,9,25,4,21,20,49,25,0
Fabian Schär,DF,Newcastle Utd,eng Premier League,31,33.9,42,24,27,13,2,18,40,45.0,22,50,38,12,36,78,133,1
Patrik Schick,FW,Leverkusen,de Bundesliga,27,11.8,6,4,0,3,3,1,5,20.0,4,2,0,2,1,7,7,0
Xaver Schlager,MF,RB Leipzig,de Bundesliga,25,27.5,81,50,35,38,8,21,53,39.6,32,41,8,33,19,100,27,0
Keven Schlotterbeck,DF,Bochum,de Bundesliga,26,24.3,42,22,26,14,2,25,30,83.3,5,33,23,10,33,75,104,2
Nico Schlotterbeck,DF,Dortmund,de Bundesliga,23,31.8,70,50,36,27,7,41,65,63.1,24,52,25,27,45,115,101,3
Jeffrey Schlupp,"FW,MF",Crystal Palace,eng Premier League,30,15.0,38,24,14,16,8,9,18,50.0,9,13,2,11,8,46,24,0
Romano Schmid,"MF,FW",Werder Bremen,de Bundesliga,23,28.9,35,20,7,22,6,14,46,30.4,32,36,7,29,11,46,17,2
Niklas Schmidt,MF,Toulouse,fr Ligue 1,25,14.1,36,21,13,19,4,16,33,48.5,17,14,7,7,4,40,13,0
Benno Schmitz,DF,Köln,de Bundesliga,28,12.8,27,15,20,7,0,17,34,50.0,17,19,4,15,7,34,29,0
Jan Schöppner,MF,Heidenheim,de Bundesliga,24,22.2,48,26,26,20,2,21,42,50.0,21,37,7,30,26,74,57,0
Marcel Schuhen,GK,Darmstadt 98,de Bundesliga,30,31.0,1,0,1,0,0,1,3,33.3,2,0,0,0,2,3,11,4
Perr Schuurs,DF,Torino,it Serie A,23,8.6,20,12,11,8,1,3,9,33.3,6,10,2,8,9,29,23,0
Marvin Schwäbe,GK,Köln,de Bundesliga,28,34.0,1,0,1,0,0,1,1,100.0,0,0,0,0,0,1,10,1
Alex Scott,MF,Bournemouth,eng Premier League,19,11.3,24,15,8,10,6,12,28,42.9,16,14,4,10,12,36,18,2
Simone Scuffet,GK,Cagliari,it Serie A,27,31.0,1,0,1,0,0,1,2,50.0,1,1,0,1,1,2,9,0
Jérémy Sebas,"FW,MF",Strasbourg,fr Ligue 1,20,4.4,7,1,2,3,2,3,5,60.0,2,3,1,2,1,8,1,0
Demba Seck,MF,Torino,it Serie A,22,4.7,5,3,1,4,0,3,4,75.0,1,1,0,1,1,6,0,0
Aleksandar Sedlar,DF,Alavés,es La Liga,31,10.5,14,10,10,4,0,10,16,62.5,6,8,4,4,13,27,43,0
Alidu Seidu,DF,Rennes,fr Ligue 1,23,6.6,21,9,17,3,1,14,19,73.7,5,11,3,8,10,31,13,0
Alidu Seidu,DF,Clermont Foot,fr Ligue 1,23,12.6,32,24,17,15,0,24,31,77.4,7,15,7,8,25,57,37,0
Nicolas Seiwald,MF,RB Leipzig,de Bundesliga,22,8.0,33,18,16,15,2,16,25,64.0,9,12,2,10,8,41,15,0
Davie Selke,FW,Köln,de Bundesliga,28,14.1,4,2,1,3,0,0,2,0.0,2,5,3,2,0,4,20,0
Matz Sels,GK,Nott'ham Forest,eng Premier League,31,16.0,0,0,0,0,0,0,0,,0,0,0,0,0,0,11,1
Matz Sels,GK,Strasbourg,fr Ligue 1,31,19.0,0,0,0,0,0,0,0,,0,2,0,2,0,0,13,1
Nélson Semedo,"DF,MF",Wolves,eng Premier League,29,34.3,79,48,52,19,8,38,64,59.4,26,44,8,36,36,115,85,1
Antoine Semenyo,FW,Bournemouth,eng Premier League,23,23.4,24,17,7,9,8,9,27,33.3,18,39,2,37,6,30,21,0
Marvin Senaya,"DF,MF",Strasbourg,fr Ligue 1,22,23.8,72,53,38,25,9,42,68,61.8,26,40,13,27,41,113,68,0
Marcos Senesi,DF,Bournemouth,eng Premier League,26,24.9,55,32,28,23,4,24,56,42.9,32,50,23,27,35,90,109,1
Suat Serdar,MF,Hellas Verona,it Serie A,26,18.4,51,39,24,23,4,22,45,48.9,23,29,7,22,20,71,25,1
Benjamin Šeško,FW,RB Leipzig,de Bundesliga,20,17.0,13,5,2,7,4,2,9,22.2,7,23,2,21,3,16,27,0
Kevin Sessa,"MF,FW",Heidenheim,de Bundesliga,23,11.2,17,10,9,6,2,7,16,43.8,9,12,1,11,4,21,17,0
Aaron Seydel,FW,Darmstadt 98,de Bundesliga,27,6.9,3,2,0,2,1,0,3,0.0,3,8,2,6,1,4,9,0
Stephan El Shaarawy,"FW,DF",Roma,it Serie A,30,19.3,21,13,14,4,3,6,15,40.0,9,11,4,7,13,34,15,2
Luke Shaw,DF,Manchester Utd,eng Premier League,28,10.7,11,8,7,3,1,9,15,60.0,6,18,11,7,6,17,39,0
Eldor Shomurodov,"FW,MF",Cagliari,it Serie A,28,10.4,11,4,2,6,3,6,10,60.0,4,5,0,5,4,15,4,0
Steven Shpendi,"FW,MF",Empoli,it Serie A,20,4.6,0,0,0,0,0,0,4,0.0,4,2,1,1,1,1,0,0
Vincent Sierro,MF,Toulouse,fr Ligue 1,27,25.1,41,24,15,20,6,27,77,35.1,50,37,13,24,27,68,33,0
Tim Siersleben,DF,Heidenheim,de Bundesliga,23,10.1,27,11,21,6,0,8,20,40.0,12,16,10,6,21,48,29,1
Kiliann Sildillia,DF,Freiburg,de Bundesliga,21,20.1,43,19,28,8,7,26,42,61.9,16,33,15,18,22,65,64,0
André Silva,FW,Real Sociedad,es La Liga,27,8.1,2,2,0,0,2,0,4,0.0,4,3,0,3,1,3,3,0
Bernardo Silva,"MF,FW",Manchester City,eng Premier League,28,28.6,51,23,13,25,13,25,57,43.9,32,32,4,28,17,68,15,1
Caio Henrique Oliveira Silva,DF,Monaco,fr Ligue 1,26,6.9,13,7,3,7,3,6,9,66.7,3,8,2,6,6,19,9,0
Rui Silva,GK,Betis,es La Liga,29,27.5,0,0,0,0,0,0,3,0.0,3,0,0,0,1,1,13,1
Thiago Silva,DF,Chelsea,eng Premier League,38,28.1,29,15,22,6,1,20,34,58.8,14,33,24,9,26,55,153,4
Marco Silvestri,GK,Udinese,it Serie A,32,17.0,0,0,0,0,0,0,3,0.0,3,1,0,1,0,0,5,3
Mohamed Simakan,DF,RB Leipzig,de Bundesliga,23,23.8,48,29,28,19,1,32,44,72.7,12,36,14,22,29,77,69,0
Giovanni Simeone,FW,Napoli,it Serie A,28,8.9,12,4,1,3,8,3,12,25.0,9,11,0,11,1,13,7,0
Giuliano Simeone,FW,Alavés,es La Liga,20,7.0,7,5,2,3,2,5,17,29.4,12,10,0,10,5,12,3,0
Moses Simon,"FW,MF",Nantes,fr Ligue 1,28,19.9,7,5,2,5,0,2,8,25.0,6,9,1,8,3,10,5,1
Unai Simón,GK,Athletic Club,es La Liga,26,35.4,2,1,1,1,0,2,3,66.7,1,0,0,0,1,3,9,0
Xavi Simons,MF,RB Leipzig,de Bundesliga,20,29.5,30,17,10,11,9,15,31,48.4,16,23,0,23,16,46,4,0
Wilfried Singo,DF,Monaco,fr Ligue 1,22,24.3,34,25,18,14,2,17,26,65.4,9,27,14,13,51,85,81,2
Luis Sinisterra,"FW,MF",Bournemouth,eng Premier League,24,7.8,23,12,9,10,4,9,16,56.3,7,18,0,18,8,31,4,0
Daley Sinkgraven,DF,Las Palmas,es La Liga,28,4.3,11,5,6,5,0,2,8,25.0,6,5,3,2,6,17,9,0
Jailson Siqueira,"DF,MF",Celta Vigo,es La Liga,27,10.0,27,18,22,5,0,13,24,54.2,11,13,5,8,12,39,32,0
Ibrahima Sissoko,MF,Strasbourg,fr Ligue 1,25,18.2,47,33,13,25,9,23,30,76.7,7,21,8,13,19,66,30,0
Moussa Sissoko,MF,Nantes,fr Ligue 1,33,20.2,27,16,13,8,6,12,25,48.0,13,8,2,6,12,39,31,0
Antonio Sivera,GK,Alavés,es La Liga,26,34.0,0,0,0,0,0,0,1,0.0,1,0,0,0,0,0,17,1
Tim Skarke,"FW,DF",Darmstadt 98,de Bundesliga,26,26.7,26,16,12,10,4,10,28,35.7,18,25,2,23,6,32,20,0
Ellyes Skhiri,MF,Eint Frankfurt,de Bundesliga,28,24.1,44,24,18,19,7,19,36,52.8,17,33,4,29,39,83,47,2
Oliver Skipp,"MF,DF",Tottenham,eng Premier League,22,7.9,18,12,9,6,3,11,18,61.1,7,12,1,11,3,21,9,0
Leo Skiri Østigård,DF,Napoli,it Serie A,23,18.1,24,12,13,10,1,6,11,54.5,5,18,12,6,16,40,65,0
Łukasz Skorupski,GK,Bologna,it Serie A,32,32.0,2,2,2,0,0,2,3,66.7,1,0,0,0,1,3,11,3
Robert Skov,"DF,FW",Hoffenheim,de Bundesliga,27,14.0,24,16,15,8,1,17,36,47.2,19,17,4,13,10,34,23,1
Milan Škriniar,DF,Paris S-G,fr Ligue 1,28,18.1,24,18,17,7,0,14,22,63.6,8,19,10,9,12,36,51,2
Chris Smalling,DF,Roma,it Serie A,33,4.3,1,1,1,0,0,1,4,25.0,3,6,5,1,5,6,8,0
Adam Smith,DF,Bournemouth,eng Premier League,32,23.9,37,23,18,11,8,19,39,48.7,20,28,11,17,21,58,62,0
Rubén Sobrino,"MF,FW",Cádiz,es La Liga,31,18.3,52,28,18,26,8,22,51,43.1,29,26,2,24,16,68,18,0
Alex Sola,"FW,MF",Alavés,es La Liga,24,14.0,27,15,11,9,7,14,26,53.8,12,18,2,16,11,38,16,0
Dominic Solanke,FW,Bournemouth,eng Premier League,25,36.9,23,11,3,13,7,10,29,34.5,19,24,5,19,7,30,43,0
Carlos Soler,"MF,DF",Paris S-G,fr Ligue 1,26,12.1,15,10,9,2,4,6,21,28.6,15,10,3,7,5,20,11,1
Jhon Solis,MF,Girona,es La Liga,18,4.3,10,8,4,5,1,4,12,33.3,8,8,3,5,8,18,7,1
Yann Sommer,GK,Inter,it Serie A,34,34.0,2,1,2,0,0,2,2,100.0,0,1,0,1,0,2,7,1
David Soria,GK,Getafe,es La Liga,30,37.9,0,0,0,0,0,0,2,0.0,2,0,0,0,0,0,21,6
Alessandro Sorrentino,GK,Monza,it Serie A,21,6.1,0,0,0,0,0,0,0,,0,0,0,0,0,0,0,0
Hugo Sotelo,MF,Celta Vigo,es La Liga,19,8.0,19,17,3,13,3,8,20,40.0,12,7,1,6,2,21,5,0
Florian Sotoca,"MF,FW",Lens,fr Ligue 1,32,28.9,33,22,9,21,3,17,38,44.7,21,41,4,37,20,53,34,0
Riccardo Sottil,FW,Fiorentina,it Serie A,24,12.3,10,5,5,1,4,3,8,37.5,5,12,0,12,2,12,2,0
Tomáš Souček,MF,West Ham,eng Premier League,28,31.9,53,35,24,26,3,21,47,44.7,26,55,28,27,37,90,109,0
Matìas Soulé,"FW,MF",Frosinone,it Serie A,20,34.7,41,27,12,14,15,19,40,47.5,21,38,4,34,18,59,9,0
Boubakary Soumaré,MF,Sevilla,es La Liga,24,25.4,39,28,24,14,1,14,26,53.8,12,25,7,18,26,65,20,1
Vinicius Souza,MF,Sheffield Utd,eng Premier League,24,29.6,125,76,59,51,15,41,74,55.4,33,57,17,40,32,157,75,1
Djibril Sow,MF,Sevilla,es La Liga,26,16.2,28,21,15,8,5,9,25,36.0,16,20,3,17,17,45,8,1
Saidou Sow,DF,Strasbourg,fr Ligue 1,21,8.0,20,12,17,3,0,9,13,69.2,4,7,4,3,12,32,36,3
Djed Spence,DF,Genoa,it Serie A,22,9.5,16,10,12,4,0,8,10,80.0,2,20,5,15,8,24,28,0
Stijn Spierings,MF,Toulouse,fr Ligue 1,27,16.8,53,40,26,20,7,29,52,55.8,23,22,5,17,26,79,32,0
Leonardo Spinazzola,DF,Roma,it Serie A,30,14.6,15,7,10,5,0,8,18,44.4,10,8,2,6,3,18,15,0
Marco Sportiello,GK,Milan,it Serie A,31,7.0,0,0,0,0,0,0,0,,0,0,0,0,0,0,2,0
Anton Stach,MF,Hoffenheim,de Bundesliga,24,25.8,73,42,40,27,6,33,63,52.4,30,38,12,26,72,145,67,1
Jens Stage,MF,Werder Bremen,de Bundesliga,26,25.9,52,22,21,23,8,18,50,36.0,32,42,23,19,23,75,55,0
Josip Stanišić,DF,Leverkusen,de Bundesliga,23,14.0,38,20,19,13,6,22,33,66.7,11,18,3,15,9,47,26,0
Carl Starfelt,DF,Celta Vigo,es La Liga,28,24.6,36,30,30,5,1,19,28,67.9,9,35,28,7,34,70,159,2
Niklas Stark,DF,Werder Bremen,de Bundesliga,28,12.1,26,15,13,11,2,12,18,66.7,6,14,7,7,19,45,61,1
Jason Steele,GK,Brighton,eng Premier League,32,17.0,0,0,0,0,0,0,3,0.0,3,0,0,0,0,0,8,1
Pascal Stenzel,DF,Stuttgart,de Bundesliga,27,11.8,18,8,7,9,2,10,30,33.3,20,22,8,14,15,33,26,0
Leonidas Stergiou,DF,Stuttgart,de Bundesliga,21,6.6,15,8,7,7,1,9,13,69.2,4,8,1,7,5,20,13,0
Raheem Sterling,"FW,MF",Chelsea,eng Premier League,28,22.0,21,10,7,8,6,12,26,46.2,14,13,0,13,13,34,9,1
Angelo Stiller,MF,Stuttgart,de Bundesliga,22,29.9,55,33,15,34,6,24,42,57.1,18,41,13,28,28,83,25,2
Kevin Stöger,MF,Bochum,de Bundesliga,29,29.6,49,30,21,21,7,25,63,39.7,38,46,4,42,19,68,18,0
John Stones,"DF,MF",Manchester City,eng Premier League,29,11.8,2,1,1,0,1,0,3,0.0,3,11,7,4,10,12,21,0
Jørgen Strand Larsen,FW,Celta Vigo,es La Liga,23,31.8,21,11,1,15,5,8,38,21.1,30,15,1,14,5,26,17,0
Gabriel Strefezza,FW,Lecce,it Serie A,26,12.4,24,17,8,7,9,14,20,70.0,6,17,0,17,7,31,11,0
Kevin Strootman,MF,Genoa,it Serie A,33,13.4,34,19,13,18,3,15,31,48.4,16,20,6,14,7,41,22,0
Cristhian Stuani,FW,Girona,es La Liga,36,8.9,14,11,4,6,4,4,7,57.1,3,9,2,7,5,19,13,0
Álex Suárez,DF,Las Palmas,es La Liga,30,28.5,53,36,33,15,5,31,37,83.8,6,33,14,19,18,71,84,0
Damián Suárez,DF,Getafe,es La Liga,35,14.4,36,21,16,16,4,26,45,57.8,19,13,3,10,10,46,31,0
Gabriel Suazo,DF,Toulouse,fr Ligue 1,25,26.2,66,32,40,19,7,38,86,44.2,48,37,4,33,26,92,33,0
Isaac Success,"FW,MF",Udinese,it Serie A,27,9.8,6,4,0,5,1,1,3,33.3,2,6,1,5,2,8,11,0
Niklas Süle,DF,Dortmund,de Bundesliga,27,16.8,18,10,14,3,1,11,16,68.8,5,25,14,11,25,43,58,2
Ibrahim Sulemana,MF,Cagliari,it Serie A,20,14.9,36,14,15,15,6,17,27,63.0,10,24,5,19,7,43,23,0
Tomáš Suslov,"MF,FW",Hellas Verona,it Serie A,21,23.2,42,30,11,22,9,15,47,31.9,32,15,0,15,6,48,8,0
Suso,"MF,FW",Sevilla,es La Liga,29,16.9,24,17,14,8,2,8,28,28.6,20,9,0,9,5,29,4,0
Mattias Svanberg,MF,Wolfsburg,de Bundesliga,24,19.1,37,17,8,19,10,12,38,31.6,26,25,5,20,21,58,28,0
Mile Svilar,GK,Roma,it Serie A,23,15.0,0,0,0,0,0,0,0,,0,0,0,0,0,0,2,1
Williot Swedberg,"FW,MF",Celta Vigo,es La Liga,19,4.9,9,4,3,6,0,5,8,62.5,3,11,1,10,0,9,4,0
Karol Świderski,"FW,MF",Hellas Verona,it Serie A,26,5.6,7,3,1,3,3,2,3,66.7,1,6,4,2,1,8,8,0
Abakar Sylla,DF,Strasbourg,fr Ligue 1,20,19.9,54,23,30,19,5,29,40,72.5,11,40,11,29,26,80,70,2
Issiaga Sylla,"DF,FW",Montpellier,fr Ligue 1,29,16.2,28,17,20,6,2,16,34,47.1,18,21,7,14,23,51,53,0
Wojciech Szczęsny,GK,Juventus,it Serie A,33,35.0,0,0,0,0,0,0,0,,0,0,0,0,1,1,11,2
Dominik Szoboszlai,MF,Liverpool,eng Premier League,22,23.4,32,19,12,12,8,16,50,32.0,34,37,2,35,15,47,16,1
Alexander Sørloth,FW,Villarreal,es La Liga,27,27.7,6,3,1,2,3,2,6,33.3,4,9,4,5,0,6,26,0
Musa Al-Taamari,FW,Montpellier,fr Ligue 1,26,21.4,20,16,10,5,5,9,21,42.9,12,18,2,16,4,24,5,0
Nicolás Tagliafico,DF,Lyon,fr Ligue 1,30,23.6,54,34,23,22,9,22,49,44.9,27,25,8,17,28,82,43,0
Jonathan Tah,DF,Leverkusen,de Bundesliga,27,29.2,19,9,10,7,2,5,16,31.3,11,28,23,5,23,42,97,1
Montassar Talbi,DF,Lorient,fr Ligue 1,25,24.5,38,22,23,13,2,19,32,59.4,13,39,23,16,32,70,114,0
Adrien Tameze,"DF,MF",Torino,it Serie A,29,23.8,35,16,13,18,4,18,37,48.6,19,24,11,13,47,82,25,2
Renato Tapia,"MF,DF",Celta Vigo,es La Liga,28,14.9,41,29,19,19,3,14,25,56.0,11,31,7,24,21,62,50,1
Edmond Tapsoba,DF,Leverkusen,de Bundesliga,24,23.2,34,25,17,15,2,17,24,70.8,7,21,10,11,24,58,52,3
Oussama Targhalline,MF,Le Havre,fr Ligue 1,21,11.4,23,11,16,7,0,15,25,60.0,10,9,3,6,20,43,14,2
James Tarkowski,DF,Everton,eng Premier League,30,38.0,61,42,46,14,1,27,48,56.3,21,82,56,26,56,117,191,2
Nuno Tavares,DF,Nott'ham Forest,eng Premier League,23,5.1,11,7,9,1,1,8,9,88.9,1,6,0,6,1,12,21,0
Marcus Tavernier,FW,Bournemouth,eng Premier League,24,23.5,53,34,25,22,6,26,48,54.2,22,31,3,28,5,58,23,0
Charlie Taylor,DF,Burnley,eng Premier League,29,25.9,35,20,19,14,2,17,35,48.6,18,27,11,16,19,54,78,0
Loum Tchaouna,"FW,MF",Salernitana,it Serie A,19,23.3,20,10,5,13,2,10,20,50.0,10,20,1,19,4,24,16,1
Jackson Tchatchoua,DF,Hellas Verona,it Serie A,21,19.2,39,26,25,12,2,23,48,47.9,25,17,7,10,23,62,49,2
Enzo Tchato,DF,Montpellier,fr Ligue 1,20,12.5,26,17,18,4,4,11,25,44.0,14,20,7,13,11,37,25,0
Aurélien Tchouaméni,"MF,DF",Real Madrid,es La Liga,23,22.1,38,23,19,17,2,9,18,50.0,9,21,13,8,28,66,52,1
Mathys Tel,"FW,MF",Bayern Munich,de Bundesliga,18,11.7,12,2,3,4,5,4,6,66.7,2,11,0,11,6,18,6,0
Nathan Tella,"DF,MF",Leverkusen,de Bundesliga,24,9.1,13,8,6,5,2,5,10,50.0,5,10,0,10,3,16,8,0
Nahuel Tenaglia,DF,Alavés,es La Liga,27,12.7,29,19,22,4,3,16,28,57.1,12,14,8,6,12,41,59,0
Arnau Tenas,GK,Paris S-G,fr Ligue 1,22,5.9,0,0,0,0,0,0,0,,0,0,0,0,0,0,0,0
Marc-André ter Stegen,GK,Barcelona,es La Liga,31,28.0,0,0,0,0,0,0,0,,0,0,0,0,0,0,3,3
Filippo Terracciano,DF,Hellas Verona,it Serie A,20,14.4,30,19,23,6,1,17,31,54.8,14,24,6,18,20,50,17,0
Pietro Terracciano,GK,Fiorentina,it Serie A,33,33.0,1,1,1,0,0,1,3,33.3,2,1,0,1,0,1,8,0
Ramón Terrats,"MF,DF",Villarreal,es La Liga,22,8.7,17,13,8,8,1,7,15,46.7,8,11,1,10,3,20,9,0
Martin Terrier,"FW,MF",Rennes,fr Ligue 1,26,17.0,14,9,3,8,3,6,14,42.9,8,21,4,17,9,23,17,0
Kenny Tete,DF,Fulham,eng Premier League,27,9.6,27,17,19,6,2,11,19,57.9,8,10,3,7,16,43,35,0
Teddy Teuma,MF,Reims,fr Ligue 1,29,23.5,54,36,19,21,14,25,62,40.3,37,33,4,29,20,74,6,0
Florian Thauvin,FW,Udinese,it Serie A,30,19.0,7,4,2,4,1,4,13,30.8,9,9,1,8,3,10,2,0
Arthur Theate,DF,Rennes,fr Ligue 1,23,25.5,30,17,19,6,5,24,37,64.9,13,40,23,17,31,61,90,2
Norman Theuerkauf,"MF,DF",Heidenheim,de Bundesliga,36,14.0,24,16,13,7,4,13,22,59.1,9,16,6,10,14,38,21,0
Malick Thiaw,DF,Milan,it Serie A,21,18.0,34,17,15,17,2,12,25,48.0,13,23,13,10,13,47,55,0
Jan Thielmann,"FW,DF",Köln,de Bundesliga,21,17.5,28,18,13,9,6,12,24,50.0,12,31,6,25,8,36,28,0
Denis Thomalla,"MF,FW",Heidenheim,de Bundesliga,30,5.0,9,6,4,4,1,5,11,45.5,6,3,2,1,4,13,13,0
Luke Thomas,DF,Sheffield Utd,eng Premier League,22,10.2,20,9,13,6,1,8,14,57.1,6,23,5,18,10,30,27,0
Adrien Thomasson,MF,Lens,fr Ligue 1,29,13.3,25,14,4,16,5,11,34,32.4,23,14,0,14,9,34,10,1
Morten Thorsby,MF,Genoa,it Serie A,27,12.9,19,11,9,8,2,7,14,50.0,7,21,5,16,4,23,20,0
Kristian Thorstvedt,MF,Sassuolo,it Serie A,24,26.6,40,22,7,28,5,22,44,50.0,22,25,9,16,21,61,36,0
Khéphren Thuram,MF,Nice,fr Ligue 1,22,23.4,42,29,13,23,6,20,40,50.0,20,21,10,11,18,60,37,0
Marcus Thuram,FW,Inter,it Serie A,25,29.9,23,15,9,9,5,4,13,30.8,9,26,3,23,4,27,19,0
Cheikh Tidiane Sabaly,"FW,MF",Metz,fr Ligue 1,24,15.3,40,20,23,12,5,16,40,40.0,24,19,2,17,10,50,14,0
Youri Tielemans,"MF,FW",Aston Villa,eng Premier League,26,18.0,41,20,17,18,6,16,40,40.0,24,23,3,20,15,56,9,0
Kieran Tierney,DF,Real Sociedad,es La Liga,26,13.8,37,24,16,18,3,18,27,66.7,9,22,8,14,10,47,45,0
Phillip Tietz,FW,Augsburg,de Bundesliga,26,26.5,23,14,7,13,3,6,15,40.0,9,17,3,14,6,29,35,0
Steffen Tigges,FW,Köln,de Bundesliga,25,8.1,10,6,4,5,1,3,7,42.9,4,4,2,2,1,11,12,0
Jean-Clair Todibo,DF,Nice,fr Ligue 1,23,29.5,58,28,35,17,6,34,56,60.7,22,34,15,19,38,96,97,1
Harry Toffolo,DF,Nott'ham Forest,eng Premier League,27,16.2,26,14,20,6,0,15,24,62.5,9,34,13,21,14,40,49,0
Umut Tohumcu,MF,Hoffenheim,de Bundesliga,18,11.2,16,12,9,7,0,6,19,31.6,13,11,1,10,6,22,12,0
Corentin Tolisso,MF,Lyon,fr Ligue 1,28,19.3,33,21,13,11,9,14,33,42.4,19,26,9,17,10,43,18,0
Jeremy Toljan,DF,Sassuolo,it Serie A,28,23.1,13,10,8,4,1,9,15,60.0,6,17,5,12,16,29,49,1
Rafael Tolói,DF,Atalanta,it Serie A,32,10.7,20,9,7,8,5,14,27,51.9,13,9,4,5,13,33,29,0
Raúl de Tomás,FW,Rayo Vallecano,es La Liga,28,14.1,9,5,4,3,2,3,6,50.0,3,3,0,3,1,10,8,0
Tiago Tomás,"FW,MF",Wolfsburg,de Bundesliga,21,11.5,5,2,3,0,2,1,6,16.7,5,13,0,13,3,8,9,0
Takehiro Tomiyasu,DF,Arsenal,eng Premier League,24,12.8,20,9,15,4,1,11,18,61.1,7,10,4,6,18,38,33,0
Fikayo Tomori,DF,Milan,it Serie A,25,23.6,42,24,29,10,3,18,29,62.1,11,34,23,11,26,68,75,1
Sandro Tonali,MF,Newcastle Utd,eng Premier League,23,4.9,7,7,4,2,1,3,9,33.3,6,3,0,3,2,9,4,0
Ivan Toney,FW,Brentford,eng Premier League,27,16.1,15,5,2,7,6,6,14,42.9,8,5,1,4,10,25,18,0
Pablo Torre,"MF,FW",Girona,es La Liga,20,7.8,5,2,0,5,0,4,10,40.0,6,10,2,8,4,9,6,1
Raúl Torrente,DF,Granada,es La Liga,21,13.9,29,16,20,9,0,17,22,77.3,5,16,10,6,11,40,68,2
Ferrán Torres,FW,Barcelona,es La Liga,23,13.5,9,6,1,6,2,5,16,31.3,11,7,1,6,5,14,6,0
Óliver Torres,MF,Sevilla,es La Liga,28,18.0,37,22,17,15,5,22,57,38.6,35,40,4,36,6,43,6,0
Pau Torres,DF,Aston Villa,eng Premier League,26,27.4,29,18,17,11,1,14,30,46.7,16,28,12,16,14,43,75,0
Lucas Torró,MF,Osasuna,es La Liga,29,19.9,25,15,11,8,6,11,28,39.3,17,10,2,8,33,58,37,0
Abdoulaye Touré,MF,Le Havre,fr Ligue 1,29,25.4,47,28,22,22,3,30,60,50.0,30,30,8,22,25,72,33,0
Souleymane Touré,DF,Lorient,fr Ligue 1,20,22.8,25,12,16,9,0,8,14,57.1,6,38,20,18,36,61,101,2
Lucas Tousart,MF,Union Berlin,de Bundesliga,26,17.5,35,20,14,17,4,17,37,45.9,20,32,9,23,25,60,41,0
Andros Townsend,"MF,FW",Luton Town,eng Premier League,32,13.4,21,13,11,2,8,13,27,48.1,14,12,0,12,5,26,10,0
James Trafford,GK,Burnley,eng Premier League,20,28.0,2,1,2,0,0,2,2,100.0,0,0,0,0,1,3,18,1
Adama Traoré,"FW,MF",Fulham,eng Premier League,27,4.2,4,3,1,2,1,3,6,50.0,3,2,0,2,1,5,2,0
Bertrand Traoré,MF,Villarreal,es La Liga,27,6.3,5,4,2,1,2,1,4,25.0,3,6,0,6,1,6,2,0
Boubacar Traoré,MF,Wolves,eng Premier League,21,9.1,35,23,16,17,2,9,21,42.9,12,12,2,10,5,40,7,0
Hamari Traoré,DF,Real Sociedad,es La Liga,31,25.5,44,19,24,17,3,25,43,58.1,18,27,8,19,24,68,59,2
Ismaël Traoré,DF,Metz,fr Ligue 1,36,24.7,19,12,13,6,0,8,21,38.1,13,33,20,13,30,49,86,0
Omar Traoré,DF,Heidenheim,de Bundesliga,25,27.5,60,33,33,21,6,32,56,57.1,24,32,7,25,40,100,54,1
Kevin Trapp,GK,Eint Frankfurt,de Bundesliga,33,32.0,0,0,0,0,0,0,0,,0,0,0,0,1,1,9,1
Mark Travers,GK,Bournemouth,eng Premier League,24,4.0,0,0,0,0,0,0,0,,0,0,0,0,0,0,2,0
Óscar Trejo,"FW,MF",Rayo Vallecano,es La Liga,35,15.3,27,15,11,9,7,13,21,61.9,8,21,1,20,5,32,9,0
Mike Trésor,"FW,MF",Burnley,eng Premier League,24,4.7,10,6,9,1,0,8,18,44.4,10,5,0,5,1,11,1,0
Christopher Trimmel,DF,Union Berlin,de Bundesliga,36,18.3,23,15,12,10,1,13,33,39.4,20,16,3,13,13,36,57,0
Kieran Trippier,DF,Newcastle Utd,eng Premier League,32,24.8,57,27,30,16,11,37,77,48.1,40,41,8,33,24,81,57,3
Leandro Trossard,"FW,MF",Arsenal,eng Premier League,28,18.3,27,16,8,9,10,9,25,36.0,16,27,1,26,8,35,6,0
Adrien Truffert,DF,Rennes,fr Ligue 1,21,23.8,39,21,23,10,6,25,40,62.5,15,31,5,26,19,58,49,0
Auston Trusty,DF,Sheffield Utd,eng Premier League,24,28.6,47,30,31,13,3,21,43,48.8,22,41,22,19,35,82,153,3
Kostas Tsimikas,DF,Liverpool,eng Premier League,27,7.5,19,13,9,6,4,9,15,60.0,6,9,1,8,6,25,10,0
Viktor Tsyhankov,"MF,FW",Girona,es La Liga,25,22.8,29,20,11,13,5,14,26,53.8,12,18,1,17,12,41,24,0
Stefano Turati,GK,Frosinone,it Serie A,21,30.5,0,0,0,0,0,0,0,,0,0,0,0,0,0,6,3
Matt Turner,GK,Nott'ham Forest,eng Premier League,29,17.0,0,0,0,0,0,0,0,,0,0,0,0,0,0,8,4
Beñat Turrientes,MF,Real Sociedad,es La Liga,21,18.7,31,17,6,20,5,13,30,43.3,17,19,8,11,6,37,17,0
Tuta,DF,Eint Frankfurt,de Bundesliga,24,28.9,63,33,38,19,6,39,59,66.1,20,29,12,17,36,99,99,0
Destiny Udogie,DF,Tottenham,eng Premier League,20,26.6,68,33,41,16,11,27,49,55.1,22,27,8,19,37,105,80,5
Matthieu Udol,DF,Metz,fr Ligue 1,27,30.0,55,37,38,12,5,38,56,67.9,18,62,16,46,50,105,108,0
Manuel Ugarte Ribeiro,MF,Paris S-G,fr Ligue 1,22,21.5,98,57,39,43,16,43,89,48.3,46,27,6,21,40,138,25,2
Sven Ulreich,GK,Bayern Munich,de Bundesliga,34,11.0,1,0,1,0,0,1,1,100.0,0,0,0,0,0,1,3,2
Deniz Undav,"FW,MF",Stuttgart,de Bundesliga,27,23.2,28,13,6,8,14,4,15,26.7,11,17,0,17,6,34,5,0
Dayot Upamecano,DF,Bayern Munich,de Bundesliga,24,19.6,34,21,21,11,2,15,29,51.7,14,19,7,12,19,53,56,3
Kacper Urbanski,"MF,FW",Bologna,it Serie A,18,10.3,16,10,5,10,1,6,13,46.2,7,15,1,14,4,20,14,0
Mark Uth,"MF,FW",Köln,de Bundesliga,31,4.1,8,4,2,3,3,4,12,33.3,8,6,0,6,1,9,2,0
Myrto Uzuni,FW,Granada,es La Liga,28,27.2,18,14,8,7,3,6,27,22.2,21,19,3,16,4,22,7,0
Josha Vagnoman,DF,Stuttgart,de Bundesliga,22,13.1,28,18,15,11,2,15,30,50.0,15,11,5,6,2,30,16,1
Óscar Valentín,MF,Rayo Vallecano,es La Liga,28,29.9,107,66,39,62,6,46,101,45.5,55,62,10,52,35,142,52,1
Emanuele Valeri,DF,Frosinone,it Serie A,24,13.1,19,16,10,5,4,10,21,47.6,11,14,3,11,9,28,22,0
Martin Valjent,DF,Mallorca,es La Liga,27,26.1,34,18,19,13,2,18,30,60.0,12,26,11,15,29,63,112,1
Álvaro Vallés,GK,Las Palmas,es La Liga,26,36.3,3,2,3,0,0,3,8,37.5,5,0,0,0,0,3,40,1
Federico Valverde,MF,Real Madrid,es La Liga,25,32.3,47,34,22,13,12,24,42,57.1,18,39,2,37,43,90,40,0
Kévin Van Den Kerkhof,"FW,MF",Metz,fr Ligue 1,27,21.3,31,24,11,13,7,13,32,40.6,19,15,2,13,11,42,32,1
Virgil van Dijk,DF,Liverpool,eng Premier League,32,35.3,40,23,24,13,3,12,14,85.7,2,47,34,13,39,79,144,0
Vanderson,DF,Monaco,fr Ligue 1,22,18.2,60,41,20,30,10,32,70,45.7,38,29,2,27,35,95,37,1
Raphaël Varane,DF,Manchester Utd,eng Premier League,30,15.3,18,11,10,7,1,10,14,71.4,4,23,18,5,15,33,88,0
Ruben Vargas,"MF,FW",Augsburg,de Bundesliga,24,21.8,23,10,6,10,7,10,25,40.0,15,19,4,15,7,30,17,0
Johan Vásquez,DF,Genoa,it Serie A,24,31.7,51,33,38,11,2,32,50,64.0,18,50,26,24,45,96,113,0
José Luis García Vayá,MF,Valencia,es La Liga,24,36.7,78,53,36,36,6,37,71,52.1,34,41,10,31,49,127,71,0
Jesus Vazquez,"DF,MF",Valencia,es La Liga,20,8.0,24,12,13,8,3,10,16,62.5,6,17,4,13,3,27,24,0
Kevin Vázquez,DF,Celta Vigo,es La Liga,30,7.8,15,13,7,7,1,12,21,57.1,9,11,3,8,5,20,25,0
Lucas Vázquez,DF,Real Madrid,es La Liga,32,15.8,37,25,22,14,1,18,25,72.0,7,27,5,22,12,49,36,0
Matías Vecino,MF,Lazio,it Serie A,31,12.8,32,17,12,20,0,20,31,64.5,11,17,5,12,12,44,21,0
Miloš Veljković,DF,Werder Bremen,de Bundesliga,27,21.3,31,15,17,13,1,16,31,51.6,15,31,20,11,17,48,57,0
Joël Veltman,DF,Brighton,eng Premier League,31,17.6,54,41,32,17,5,39,58,67.2,19,17,7,10,18,72,57,1
Micky van de Ven,DF,Tottenham,eng Premier League,22,26.0,49,35,34,12,3,24,33,72.7,9,25,15,10,18,67,78,1
Lorenzo Venuti,DF,Lecce,it Serie A,28,4.0,6,4,5,1,0,6,10,60.0,4,4,3,1,5,11,14,0
Bart Verbruggen,GK,Brighton,eng Premier League,20,21.0,1,1,1,0,0,1,2,50.0,1,0,0,0,0,1,11,3
Jordan Veretout,MF,Marseille,fr Ligue 1,30,24.3,38,22,19,13,6,18,39,46.2,21,20,4,16,13,51,25,0
Yorbe Vertessen,"FW,MF",Union Berlin,de Bundesliga,22,6.6,3,2,0,3,0,1,4,25.0,3,8,0,8,1,4,3,0
Mikel Vesga,MF,Athletic Club,es La Liga,30,17.0,40,20,11,23,6,19,49,38.8,30,19,7,12,32,72,35,1
Guglielmo Vicario,GK,Tottenham,eng Premier League,26,38.0,0,0,0,0,0,0,1,0.0,1,0,0,0,1,1,31,2
Carlos Vicente,FW,Alavés,es La Liga,24,12.4,16,6,7,7,2,10,25,40.0,15,4,0,4,4,20,9,0
Nacho Vidal,DF,Mallorca,es La Liga,28,4.6,12,5,4,5,3,6,13,46.2,7,5,2,3,3,15,9,0
Jonathan Viera,"MF,FW",Las Palmas,es La Liga,33,6.9,6,3,1,2,3,1,9,11.1,8,0,0,0,0,6,1,0
Jonathan Viera,MF,Almería,es La Liga,33,10.1,19,9,6,9,4,10,19,52.6,9,4,0,4,4,23,1,0
Oscar Vilhelmsson,"FW,MF",Darmstadt 98,de Bundesliga,19,15.3,13,6,3,7,3,7,10,70.0,3,15,5,10,3,16,19,0
Asier Villalibre,FW,Athletic Club,es La Liga,25,5.7,2,1,0,0,2,2,2,100.0,0,2,1,1,0,2,6,0
Gonzalo Villar,MF,Granada,es La Liga,25,20.0,51,33,26,20,5,26,41,63.4,15,32,10,22,6,57,26,1
Iván Villar,GK,Celta Vigo,es La Liga,26,11.3,0,0,0,0,0,0,1,0.0,1,0,0,0,0,0,6,0
Matías Viña,DF,Sassuolo,it Serie A,25,11.3,34,21,22,7,5,20,36,55.6,16,12,2,10,9,43,34,0
Nicolas Viola,"MF,FW",Cagliari,it Serie A,33,13.4,13,9,2,8,3,7,17,41.2,10,9,0,9,2,15,6,0
Alan Virginius,FW,Clermont Foot,fr Ligue 1,20,10.4,9,5,4,4,1,4,11,36.4,7,7,0,7,3,12,7,0
Mattia Viti,DF,Sassuolo,it Serie A,21,10.9,24,15,14,7,3,10,22,45.5,12,20,10,10,10,34,44,0
Vitinha,FW,Marseille,fr Ligue 1,23,10.3,14,8,3,5,6,3,12,25.0,9,11,2,9,5,19,8,0
Vitinha,MF,Paris S-G,fr Ligue 1,23,23.6,39,24,12,16,11,16,48,33.3,32,29,11,18,23,62,30,2
Vitinho,"DF,MF",Burnley,eng Premier League,24,25.7,64,34,36,22,6,43,86,50.0,43,44,6,38,12,76,47,4
Daniel Vivian,DF,Athletic Club,es La Liga,24,32.0,42,28,29,11,2,28,45,62.2,17,49,25,24,31,73,104,0
Odisseas Vlachodimos,GK,Nott'ham Forest,eng Premier League,29,5.0,0,0,0,0,0,0,1,0.0,1,0,0,0,0,0,1,0
Dušan Vlahović,FW,Juventus,it Serie A,23,25.6,9,5,0,6,3,4,11,36.4,7,4,2,2,1,10,11,0
Nikola Vlašić,"MF,FW",Torino,it Serie A,25,29.0,28,16,6,14,8,4,30,13.3,26,26,7,19,11,39,16,0
Alessandro Vogliacco,DF,Genoa,it Serie A,24,13.0,23,15,14,8,1,12,15,80.0,3,16,10,6,30,53,40,1
Kevin Vogt,DF,Hoffenheim,de Bundesliga,31,14.7,14,10,7,7,0,8,13,61.5,5,16,13,3,9,23,54,0
Kevin Vogt,DF,Union Berlin,de Bundesliga,31,14.7,10,9,6,4,0,6,12,50.0,6,22,15,7,7,17,72,2
Mërgim Vojvoda,DF,Torino,it Serie A,28,15.3,17,8,7,6,4,11,16,68.8,5,12,2,10,13,30,28,0
Kevin Volland,"FW,MF",Union Berlin,de Bundesliga,31,14.9,22,9,8,8,6,8,20,40.0,12,8,0,8,6,28,12,0
Cristian Volpato,"MF,FW",Sassuolo,it Serie A,19,7.2,16,8,9,6,1,9,25,36.0,16,7,0,7,1,17,5,0
Aster Vranckx,MF,Wolfsburg,de Bundesliga,20,12.8,32,15,11,11,10,15,28,53.6,13,17,6,11,14,46,29,0
Stefan de Vrij,DF,Inter,it Serie A,31,17.6,18,13,13,4,1,8,15,53.3,7,22,10,12,24,42,51,0
Elye Wahi,FW,Lens,fr Ligue 1,20,18.8,6,4,1,3,2,2,10,20.0,8,5,1,4,3,9,3,0
Walace,MF,Udinese,it Serie A,28,36.0,66,43,40,26,0,36,77,46.8,41,43,6,37,43,109,66,1
Luca Waldschmidt,"MF,FW",Köln,de Bundesliga,27,12.7,19,12,4,12,3,5,16,31.3,11,18,3,15,6,25,8,1
Kyle Walker,DF,Manchester City,eng Premier League,33,30.7,38,24,19,17,2,19,39,48.7,20,19,6,13,27,65,40,1
Sebastian Walukiewicz,DF,Empoli,it Serie A,23,22.8,39,28,33,6,0,28,41,68.3,13,50,31,19,15,54,121,0
Aaron Wan-Bissaka,DF,Manchester Utd,eng Premier League,25,19.8,42,25,18,20,4,19,26,73.1,7,29,15,14,41,83,68,1
Joel Ward,DF,Crystal Palace,eng Premier League,33,22.0,45,28,26,18,1,30,47,63.8,17,17,10,7,14,59,94,1
James Ward-Prowse,MF,West Ham,eng Premier League,28,33.3,45,29,14,23,8,18,44,40.9,26,31,9,22,38,83,49,0
Ollie Watkins,FW,Aston Villa,eng Premier League,27,35.7,12,7,0,5,7,5,11,45.5,6,26,4,22,4,16,20,0
Timothy Weah,"DF,FW",Juventus,it Serie A,23,14.0,27,20,16,8,3,15,20,75.0,5,12,1,11,5,32,15,0
Adam Webster,DF,Brighton,eng Premier League,28,12.7,14,12,8,5,1,6,18,33.3,12,16,12,4,16,30,43,1
Wout Weghorst,FW,Hoffenheim,de Bundesliga,30,22.0,13,6,4,7,2,9,15,60.0,6,25,8,17,6,19,24,0
Julian Weigl,MF,Gladbach,de Bundesliga,27,30.7,66,40,28,32,6,41,67,61.2,26,47,14,33,48,114,61,1
Mitchell Weiser,"DF,MF",Werder Bremen,de Bundesliga,29,29.3,64,38,29,25,10,31,53,58.5,22,36,6,30,20,84,43,0
Noah Weißhaupt,"DF,FW",Freiburg,de Bundesliga,21,8.4,9,4,6,0,3,5,11,45.5,6,8,1,7,8,17,12,0
Shon Weissman,"FW,DF",Salernitana,it Serie A,27,5.5,4,3,2,0,2,0,4,0.0,4,2,1,1,3,7,4,0
Danny Welbeck,"FW,MF",Brighton,eng Premier League,32,18.8,35,17,9,17,9,10,17,58.8,7,12,0,12,9,44,17,1
Timo Werner,FW,Tottenham,eng Premier League,27,9.0,7,4,3,4,0,5,18,27.8,13,12,0,12,3,10,2,0
Adam Wharton,MF,Crystal Palace,eng Premier League,19,14.4,48,32,18,22,8,23,46,50.0,23,17,3,14,20,68,24,1
Ben White,DF,Arsenal,eng Premier League,25,33.2,48,28,20,22,6,26,58,44.8,32,48,22,26,32,80,77,1
Silvan Widmer,DF,Mainz 05,de Bundesliga,30,13.8,23,10,12,8,3,17,28,60.7,11,18,5,13,16,39,37,0
Mateusz Wieteska,DF,Cagliari,it Serie A,26,10.7,14,11,9,3,2,3,10,30.0,7,10,5,5,14,28,48,0
Iñaki Williams,FW,Athletic Club,es La Liga,29,31.6,24,17,6,8,10,13,34,38.2,21,42,8,34,14,38,29,0
Neco Williams,DF,Nott'ham Forest,eng Premier League,22,18.2,69,40,42,18,9,35,56,62.5,21,44,13,31,22,91,53,0
Nico Williams,FW,Athletic Club,es La Liga,21,25.1,31,12,9,15,7,13,36,36.1,23,18,2,16,3,34,4,1
Willian,FW,Fulham,eng Premier League,34,22.8,18,11,6,7,5,3,21,14.3,18,13,0,13,9,27,12,1
Joe Willock,MF,Newcastle Utd,eng Premier League,23,4.7,13,7,7,6,0,4,11,36.4,7,7,0,7,1,14,1,0
Callum Wilson,FW,Newcastle Utd,eng Premier League,31,11.0,5,3,0,2,3,0,4,0.0,4,6,0,6,2,7,4,0
Harry Wilson,FW,Fulham,eng Premier League,26,18.0,21,14,9,8,4,11,28,39.3,17,27,3,24,10,31,12,0
Josh Wilson-Esbrand,"DF,MF",Reims,fr Ligue 1,20,5.1,5,4,2,3,0,2,8,25.0,6,5,2,3,6,11,7,0
Patrick Wimmer,"FW,MF",Wolfsburg,de Bundesliga,22,6.5,14,5,5,5,4,8,18,44.4,10,14,0,14,3,17,7,0
Jonas Wind,FW,Wolfsburg,de Bundesliga,24,29.5,13,10,4,6,3,7,17,41.2,10,13,4,9,3,16,21,0
Florian Wirtz,MF,Leverkusen,de Bundesliga,20,26.4,27,18,7,14,6,9,29,31.0,20,36,2,34,9,36,3,0
Yoane Wissa,FW,Brentford,eng Premier League,26,27.7,28,16,13,10,5,5,20,25.0,15,24,3,21,9,37,15,0
Axel Witsel,DF,Atlético Madrid,es La Liga,34,30.9,35,21,23,12,0,17,24,70.8,7,40,21,19,16,51,119,0
Maximilian Wittek,"DF,FW",Bochum,de Bundesliga,27,11.9,23,17,9,11,3,13,21,61.9,8,12,1,11,18,41,23,0
Maximilian Wöber,DF,Gladbach,de Bundesliga,25,23.0,66,31,40,25,1,31,53,58.5,22,47,26,21,38,104,111,0
Marius Wolf,DF,Dortmund,de Bundesliga,28,13.0,20,12,8,11,1,11,23,47.8,12,12,2,10,8,28,20,0
Nick Woltemade,"FW,MF",Werder Bremen,de Bundesliga,21,13.2,34,23,7,20,7,15,21,71.4,6,12,0,12,5,39,17,0
Jeong Woo-yeong,"MF,FW",Stuttgart,de Bundesliga,23,7.0,15,9,6,8,1,6,8,75.0,2,5,0,5,7,22,5,0
Chris Wood,FW,Nott'ham Forest,eng Premier League,31,20.1,7,4,1,4,2,3,9,33.3,6,11,3,8,1,8,26,0
Cauley Woodrow,"FW,MF",Luton Town,eng Premier League,28,4.7,16,10,8,4,4,9,16,56.3,7,7,1,6,1,17,14,0
Christopher Wooh,DF,Rennes,fr Ligue 1,21,15.4,18,12,12,6,0,8,15,53.3,7,19,9,10,18,36,51,0
Joe Worrall,DF,Nott'ham Forest,eng Premier League,26,4.9,7,5,6,1,0,3,6,50.0,3,5,4,1,3,10,32,1
Granit Xhaka,MF,Leverkusen,de Bundesliga,30,31.3,29,21,11,14,4,9,30,30.0,21,29,8,21,19,48,42,0
Lamine Yamal,FW,Barcelona,es La Liga,16,24.5,61,37,32,15,14,18,48,37.5,30,32,0,32,19,80,11,0
Roman Yaremchuk,FW,Valencia,es La Liga,27,10.3,5,2,1,2,2,3,6,50.0,3,4,0,4,1,6,9,0
Yehor Yarmoliuk,MF,Brentford,eng Premier League,19,7.6,17,11,6,8,3,7,17,41.2,10,17,4,13,6,23,5,0
Ryan Yates,MF,Nott'ham Forest,eng Premier League,25,22.1,66,39,39,21,6,19,34,55.9,15,42,15,27,21,87,44,1
Yusuf Yazıcı,"MF,FW",Lille,fr Ligue 1,26,14.6,19,11,6,9,4,4,15,26.7,11,10,1,9,5,24,5,0
Bertuğ Yıldırım,FW,Rennes,fr Ligue 1,21,5.2,7,5,2,3,2,3,8,37.5,5,8,0,8,0,7,4,0
Kenan Yıldız,"FW,MF",Juventus,it Serie A,18,10.6,13,9,5,6,2,4,8,50.0,4,6,0,6,1,14,4,0
Darlin Yongwa,DF,Lorient,fr Ligue 1,22,12.9,30,23,17,11,2,14,25,56.0,11,14,2,12,15,45,36,0
Leny Yoro,DF,Lille,fr Ligue 1,17,29.7,36,25,27,7,2,17,31,54.8,14,20,14,6,36,72,97,1
Ashley Young,"DF,MF",Everton,eng Premier League,38,25.3,53,38,28,19,6,30,54,55.6,24,24,6,18,22,75,50,3
Etienne Youte Kinkoue,DF,Le Havre,fr Ligue 1,21,21.6,15,9,13,2,0,7,11,63.6,4,21,16,5,44,59,104,0
Illia Zabarnyi,DF,Bournemouth,eng Premier League,20,37.0,59,32,29,29,1,23,50,46.0,27,53,34,19,33,92,143,4
Mattia Zaccagni,"FW,MF",Lazio,it Serie A,28,21.7,27,16,11,15,1,9,21,42.9,12,26,2,24,21,48,15,0
Dan-Axel Zagadou,DF,Stuttgart,de Bundesliga,24,16.1,21,14,16,5,0,4,8,50.0,4,23,18,5,20,41,78,1
Yoram Zague,DF,Paris S-G,fr Ligue 1,17,4.1,18,8,11,4,3,11,24,45.8,13,3,0,3,4,22,9,1
Warren Zaïre-Emery,"MF,DF",Paris S-G,fr Ligue 1,17,21.8,51,28,18,24,9,28,51,54.9,23,32,8,24,15,66,22,2
Denis Zakaria,"MF,DF",Monaco,fr Ligue 1,26,23.7,38,27,11,20,7,12,30,40.0,18,39,13,26,47,85,41,0
Arsen Zakharyan,"MF,FW",Real Sociedad,es La Liga,20,13.6,22,15,8,11,3,9,22,40.9,13,16,0,16,4,26,10,0
Joseba Zaldúa,DF,Cádiz,es La Liga,31,7.8,20,12,17,2,1,13,21,61.9,8,6,4,2,2,22,20,0
Nicola Zalewski,"DF,FW",Roma,it Serie A,21,10.8,20,14,10,9,1,8,22,36.4,14,12,4,8,9,29,17,0
Andre-Frank Zambo Anguissa,MF,Napoli,it Serie A,27,31.0,61,33,21,29,11,34,69,49.3,35,40,5,35,28,89,19,1
Nicolò Zaniolo,"FW,MF",Aston Villa,eng Premier League,24,9.3,19,9,10,7,2,9,17,52.9,8,13,0,13,1,20,11,0
Alessandro Zanoli,DF,Salernitana,it Serie A,22,10.2,16,13,9,7,0,7,12,58.3,5,10,2,8,1,17,17,0
Duván Zapata,FW,Torino,it Serie A,32,32.0,18,7,9,2,7,3,12,25.0,9,20,6,14,7,25,26,0
Gabriele Zappa,DF,Cagliari,it Serie A,23,28.5,54,31,29,16,9,29,41,70.7,12,29,5,24,20,74,75,2
Davide Zappacosta,DF,Atalanta,it Serie A,31,20.7,30,20,15,10,5,16,34,47.1,18,29,4,25,5,35,19,0
Bryan Zaragoza,"MF,FW",Granada,es La Liga,22,18.2,18,9,8,6,4,8,23,34.8,15,9,0,9,3,21,3,0
Oier Zarraga,MF,Udinese,it Serie A,24,4.5,3,3,2,1,0,1,5,20.0,4,5,2,3,5,8,16,1
Mehdi Zeffane,"DF,MF",Clermont Foot,fr Ligue 1,31,13.7,31,20,17,11,3,17,34,50.0,17,14,3,11,16,47,34,0
Jordan Zemura,DF,Udinese,it Serie A,23,11.5,24,16,13,7,4,11,19,57.9,8,5,1,4,13,37,21,0
Robin Zentner,GK,Mainz 05,de Bundesliga,28,30.0,2,2,2,0,0,2,5,40.0,3,1,0,1,1,3,19,1
Alessio Zerbin,"DF,FW",Monza,it Serie A,24,7.6,18,10,13,2,3,4,13,30.8,9,16,3,13,3,21,5,0
Cedric Zesiger,DF,Wolfsburg,de Bundesliga,25,18.2,19,9,13,4,2,10,22,45.5,12,32,21,11,15,34,88,1
Michael Zetterer,GK,Werder Bremen,de Bundesliga,28,27.0,3,1,3,0,0,3,3,100.0,0,0,0,0,0,3,7,3
Nathan Zeze,DF,Nantes,fr Ligue 1,18,11.4,11,6,9,2,0,7,14,50.0,7,12,3,9,12,23,47,1
Edon Zhegrova,FW,Lille,fr Ligue 1,24,25.4,32,18,9,15,8,14,36,38.9,22,17,1,16,8,40,8,0
Piotr Zieliński,MF,Napoli,it Serie A,29,21.4,23,15,6,13,4,12,24,50.0,12,12,1,11,9,32,15,0
Christoph Zimmermann,DF,Darmstadt 98,de Bundesliga,30,13.6,33,21,26,7,0,19,39,48.7,20,21,14,7,21,54,66,1
Oleksandr Zinchenko,DF,Arsenal,eng Premier League,26,19.1,50,30,19,24,7,35,52,67.3,17,18,3,15,20,70,26,2
Joshua Zirkzee,FW,Bologna,it Serie A,22,30.7,32,20,8,15,9,13,24,54.2,11,25,2,23,3,35,36,0
Nadir Zortea,DF,Frosinone,it Serie A,24,14.0,21,14,8,13,0,10,22,45.5,12,13,5,8,4,25,29,1
Kurt Zouma,DF,West Ham,eng Premier League,28,31.5,23,17,14,9,0,10,16,62.5,6,38,28,10,29,52,160,0
Igor Zubeldia,DF,Real Sociedad,es La Liga,26,28.0,32,25,20,10,2,19,26,73.1,7,28,19,9,32,64,97,3
Martín Zubimendi,MF,Real Sociedad,es La Liga,24,29.5,49,27,18,29,2,23,42,54.8,19,33,9,24,37,86,54,0
Szymon Żurkowski,MF,Empoli,it Serie A,25,9.6,15,6,5,8,2,5,15,33.3,10,5,1,4,6,21,11,0
Martin Ødegaard,MF,Arsenal,eng Premier League,24,34.3,49,17,18,21,10,17,58,29.3,41,23,1,22,15,64,5,0
Milan Đurić,FW,Hellas Verona,it Serie A,33,13.4,1,0,0,0,1,0,3,0.0,3,0,0,0,1,2,13,0
Milan Đurić,FW,Monza,it Serie A,33,14.0,5,5,0,5,0,2,4,50.0,2,6,2,4,0,5,27,0
Mateusz Łęgowski,MF,Salernitana,it Serie A,20,12.7,23,12,8,12,3,11,26,42.3,15,13,2,11,7,30,16,0
